min_x,max_x,mean_x,std_x,range_x,min_y,max_y,mean_y,std_y,range_y,min_z,max_z,mean_z,std_z,range_z,activity
1940,1986,1961.0884615384616,7.673593436847969,46,2365,2396,2377.5846153846155,5.437300908009521,31,2086,2143,2115.726923076923,11.339208558257086,57,1
1925,1999,1956.1192307692309,12.37435757018219,74,2340,2409,2379.503846153846,9.438890254826001,69,2062,2168,2106.846153846154,18.9259730580083,106,1
1919,1999,1953.2807692307692,12.488837308615135,80,2340,2409,2380.869230769231,9.430000971628704,69,2062,2168,2101.476923076923,17.485665562068267,106,1
1919,1977,1959.7076923076922,10.208971869052563,58,2368,2394,2379.8,5.014881329506687,26,2077,2138,2107.876923076923,10.598328260841985,61,1
1941,1980,1964.1346153846155,5.983338662514563,39,2369,2390,2378.4076923076923,3.633172250243663,21,2086,2135,2113.1,6.042130080305778,49,1
1949,1980,1962.623076923077,4.671883177744541,31,2369,2388,2378.226923076923,3.0336666516170414,19,2096,2127,2113.1346153846152,4.557775172528207,31,1
1948,1978,1961.7076923076922,5.715853660738969,30,2369,2388,2378.3846153846152,3.0093409670778515,19,2099,2127,2112.0692307692307,5.358482556968466,28,1
1948,2005,1970.4384615384615,12.860405156526788,57,2346,2391,2375.9,7.359337304394029,45,2093,2181,2119.8,16.420817374395323,88,1
1925,2005,1966.5115384615385,18.07651747739271,80,2346,2397,2375.523076923077,8.409146871933627,51,2089,2181,2119.523076923077,17.932828499328764,92,1
1925,2004,1961.8461538461538,15.422723814566929,79,2356,2407,2377.6653846153845,7.134095755267254,51,2078,2139,2112.7807692307692,13.767302745586182,61,1
1929,2004,1971.5576923076924,8.77829338814982,75,2359,2407,2375.480769230769,6.232590841310587,48,2078,2139,2120.8076923076924,12.40413192700275,61,1
1957,1985,1971.873076923077,4.761821922851381,28,2359,2402,2374.3346153846155,4.385782779059012,43,2102,2146,2124.6346153846152,5.096099068917884,44,1
1946,2015,1975.3384615384616,8.714744835437097,69,2348,2407,2374.007692307692,7.564391437519467,59,2102,2158,2128.1615384615384,8.896924848242326,56,1
1946,2015,1979.303846153846,8.195251509999393,69,2348,2407,2372.480769230769,7.691670229006891,59,2106,2158,2133.2,7.868023354425907,52,1
1959,2000,1978.426923076923,5.4374688703539,41,2358,2390,2372.3076923076924,4.882948273654335,32,2117,2152,2132.5923076923077,5.2742488771104865,35,1
1963,1987,1977.746153846154,3.6003250356516925,24,2360,2390,2372.3884615384613,3.7703196635445075,30,2118,2144,2131.380769230769,3.6164061205004656,26,1
1962,1985,1976.5,3.760699023168052,23,2363,2382,2372.55,3.245638594201438,19,2120,2139,2130.2961538461536,3.5391883074871666,19,1
1962,1992,1975.8384615384616,4.620424433785488,30,2353,2395,2372.5692307692307,4.365428347478018,42,2117,2151,2130.2807692307692,4.853253434972143,34,1
1965,1992,1975.5576923076924,4.573777286820891,27,2353,2395,2372.630769230769,4.332936553232597,42,2117,2151,2130.1615384615384,5.368007397117054,34,1
1966,1985,1973.9423076923076,3.4406914404458866,19,2365,2384,2373.480769230769,3.058568473132669,19,2119,2142,2127.646153846154,4.2351015969024335,23,1
1965,1980,1972.8076923076924,2.885447855326678,15,2365,2380,2373.9153846153845,2.7468047154714412,15,2119,2133,2125.980769230769,2.892477159187971,14,1
1962,1981,1972.3923076923077,3.0044912426178954,19,2366,2383,2373.880769230769,2.969148862190134,17,2116,2133,2125.95,3.098355523468369,17,1
1962,1983,1971.9692307692308,3.3564056467386156,21,2366,2387,2373.873076923077,3.0924066538828483,21,2116,2137,2126.0846153846155,3.654023255520681,21,1
1962,1983,1970.9153846153847,3.2939270559554665,21,2367,2387,2374.3038461538463,2.8413630924864606,20,2117,2137,2125.5576923076924,3.667731888000703,20,1
1962,1978,1970.4153846153847,2.8210039982360104,16,2368,2383,2374.273076923077,2.627161025132463,15,2117,2132,2124.8038461538463,3.048511348744079,15,1
1961,1979,1970.696153846154,2.9071846521544864,18,2366,2383,2373.980769230769,2.676152258708557,17,2117,2132,2124.996153846154,3.006425649936347,15,1
1961,1980,1971.126923076923,3.066075137829592,19,2366,2383,2373.9884615384617,2.7753502576375926,17,2117,2132,2124.896153846154,2.9566991886341927,15,1
1964,1980,1971.2576923076922,2.9196013210833898,16,2366,2383,2373.8846153846152,2.816483788801372,17,2117,2134,2124.8884615384613,2.830995966888361,17,1
1963,1979,1971.123076923077,2.9039059958390583,16,2366,2383,2374.2884615384614,3.056334257109174,17,2117,2135,2125.0538461538463,2.962602264397328,18,1
1957,1979,1970.5923076923077,3.7192936470713405,22,2366,2385,2374.9846153846156,3.3931218535849714,19,2107,2142,2123.4192307692306,5.149991133235928,35,1
1952,1994,1970.5961538461538,5.434977579436854,42,2367,2388,2375.9538461538464,3.6873184289286973,21,2095,2142,2118.9653846153847,6.559701607518833,47,1
1952,1994,1970.2576923076922,5.014163189589315,42,2367,2388,2376.0307692307692,3.444963783231323,21,2095,2127,2117.6807692307693,4.738939101480816,32,1
1959,1981,1969.4038461538462,3.2302839170472595,22,2366,2385,2375.4192307692306,3.3330588442572178,19,2110,2132,2119.603846153846,3.4586337348940708,22,1
1956,1988,1969.8346153846153,4.761447681260818,32,2362,2396,2375.3076923076924,4.483080425110629,34,2099,2135,2119.7,5.177393688469654,36,1
1942,1988,1967.1153846153845,6.621171863040322,46,2354,2396,2375.9346153846154,5.155455356098035,42,2099,2146,2117.773076923077,6.88561018077756,47,1
1942,1984,1966.1038461538462,5.267440658985262,42,2354,2391,2377.019230769231,4.179793203098836,37,2103,2146,2115.2038461538464,5.611693580471483,43,1
1959,1978,1967.6538461538462,3.0786637487992214,19,2369,2387,2377.1846153846154,3.113762241327249,18,2103,2123,2114.3846153846152,3.3849191212904124,20,1
1953,1981,1966.7307692307693,4.153964402281302,28,2366,2389,2377.0538461538463,3.5002736538613166,23,2105,2134,2115.8192307692307,4.05488591604003,29,1
1953,1981,1966.5692307692307,4.51071390652743,28,2365,2389,2376.0153846153844,3.72507855973673,24,2105,2134,2120.5,5.2302210617919735,29,1
1955,1981,1967.0115384615385,4.292835633755127,26,2365,2386,2375.6,3.84165344068165,21,2103,2134,2120.976923076923,5.94240748453072,31,1
1948,1982,1966.803846153846,5.792084918079818,34,2366,2386,2376.9615384615386,3.959064368533388,20,2097,2134,2115.423076923077,6.518006404139802,37,1
1948,1985,1966.7923076923078,6.659038800217171,37,2366,2389,2377.5307692307692,3.7544073694225957,23,2097,2127,2112.4653846153847,5.342583522341854,30,1
1954,1985,1968.2769230769231,5.476542302631798,31,2366,2389,2377.3115384615385,3.4762100388262267,23,2099,2132,2114.2961538461536,5.001233883987068,33,1
1961,1978,1968.8307692307692,3.375218480646814,17,2371,2385,2377.2153846153847,2.773243965265604,14,2107,2132,2116.1692307692306,3.694174609696468,25,1
1959,1978,1968.0615384615385,3.500146375656974,19,2365,2385,2376.646153846154,3.1668201131023572,20,2107,2127,2116.7346153846156,3.7098889354367355,20,1
1955,1977,1967.45,3.748023932378687,22,2365,2384,2376.3846153846152,3.3215910393916697,19,2101,2130,2117.107692307692,4.427443641906377,29,1
1950,1975,1964.6692307692308,5.0616103188510095,25,2367,2389,2377.6115384615387,3.385048538581627,22,2100,2130,2113.6153846153848,5.793598671446406,30,1
1946,1985,1964.4115384615384,6.765505681179133,39,2368,2389,2378.0615384615385,3.782205534483644,21,2099,2130,2110.5653846153846,4.784905667337888,31,1
1946,1990,1967.3923076923077,6.425090962919816,44,2366,2387,2377.7615384615383,3.7975888431583824,21,2099,2130,2110.3846153846152,4.679511929446478,31,1
1956,1990,1966.496153846154,4.457866308288307,34,2366,2387,2378.0423076923075,3.2753523288240123,21,2098,2124,2109.8076923076924,4.102162823162901,26,1
1955,1978,1965.9769230769232,3.687535897848454,23,2371,2387,2378.0384615384614,2.9952442256831024,16,2098,2121,2109.353846153846,3.499280761094463,23,1
1955,1978,1966.053846153846,3.6840709781950416,23,2371,2387,2378.35,2.9560160500293104,16,2099,2117,2108.6653846153845,3.151201561320901,18,1
1951,1972,1962.6807692307693,4.6334789110480274,21,2365,2390,2378.4461538461537,3.608359103561537,25,2089,2131,2109.7615384615383,4.863073128123846,42,1
1951,1972,1961.9076923076923,4.3583606316260015,21,2365,2390,2377.7076923076925,3.562884939785327,25,2089,2131,2111.85,4.58684959304196,42,1
1954,1972,1963.0807692307692,3.2852212928018933,18,2369,2388,2377.4269230769232,3.013234346940382,19,2098,2123,2111.6884615384615,3.41909547105866,25,1
1955,1972,1963.2423076923078,3.3007163229711582,17,2369,2388,2377.526923076923,2.99987872242735,19,2098,2123,2111.853846153846,3.5805384260269326,25,1
1952,1971,1963.0115384615385,3.399389784336434,19,2371,2385,2377.5884615384616,2.9151219267701047,14,2103,2125,2112.2653846153844,3.505477490781026,22,1
1952,1971,1962.2269230769232,3.34480034347184,19,2368,2387,2377.5115384615383,3.1494103049277764,19,2103,2125,2111.5846153846155,3.3869716667809713,22,1
1952,1970,1962.5576923076924,3.0757079201346817,18,2368,2387,2377.05,3.088370264076328,19,2103,2124,2113.130769230769,3.751732596480921,21,1
1954,1970,1962.9692307692308,3.0527877291932564,16,2368,2384,2376.976923076923,2.951252295194382,16,2103,2124,2114.4692307692308,3.7047156874608236,21,1
1951,1974,1962.8076923076924,3.4205740308209527,23,2368,2387,2377.492307692308,2.9111585451232425,19,2098,2124,2113.1769230769232,3.8992433373795237,26,1
1939,1974,1957.4115384615384,7.006606200046528,35,2370,2387,2378.4076923076923,3.0191055819561052,17,2095,2119,2109.007692307692,5.048025958982985,24,1
1939,1967,1952.5230769230768,4.501763506213389,28,2368,2387,2378.873076923077,3.0204013761128623,19,2095,2121,2106.2038461538464,3.688757915197873,26,1
1945,1981,1957.3346153846153,6.64659127125894,36,2359,2391,2378.6923076923076,4.375865988373404,32,2093,2121,2106.726923076923,4.5701784469023785,28,1
1949,1981,1961.5653846153846,5.030366652102871,32,2359,2391,2378.257692307692,4.290482695250239,32,2093,2123,2109.0884615384616,5.07129303708759,30,1
1949,1988,1961.6423076923077,4.4199157102432265,39,2357,2391,2377.4384615384615,4.147853975816002,34,2097,2130,2112.3115384615385,4.446926570695308,33,1
1949,1988,1961.0230769230768,4.881555206036415,39,2357,2391,2377.6115384615387,4.719860848275765,34,2094,2130,2111.85,5.6592937878860985,36,1
1949,1973,1959.9076923076923,3.67701018769379,24,2366,2390,2378.15,3.4980137772885325,24,2094,2130,2109.7923076923075,4.751258567417477,36,1
1953,1968,1959.8538461538462,2.7777703857605505,15,2371,2387,2378.2653846153844,2.7018429728530577,16,2100,2118,2108.8076923076924,3.2145810510129205,18,1
1950,1968,1959.6038461538462,3.009762849241184,18,2370,2388,2378.3884615384613,2.9314994019594725,18,2099,2118,2108.1961538461537,3.2956014642230347,19,1
1950,1969,1958.9538461538461,3.227204675078731,19,2370,2388,2378.7653846153844,3.144332685456174,18,2097,2118,2107.2846153846153,3.623677211209151,21,1
1951,1969,1958.2230769230769,3.0038980714071553,18,2371,2386,2378.9423076923076,2.87589812420225,15,2097,2116,2106.980769230769,3.340926654655997,19,1
1943,1965,1957.2653846153846,3.2954212188733947,22,2370,2386,2378.6576923076923,2.8988978170347006,16,2092,2118,2107.4192307692306,3.535426798739107,26,1
1943,1966,1955.9115384615384,3.9509372255080137,23,2368,2387,2378.396153846154,3.358959754538692,19,2088,2119,2107.2846153846153,4.3215087730372685,31,1
1945,1966,1954.7307692307693,3.586306994890128,21,2368,2387,2378.3653846153848,3.2610302642444737,19,2088,2119,2107.1769230769232,3.9582090732323723,31,1
1947,1972,1955.1807692307693,4.341816002707415,25,2365,2389,2378.3,3.7615202709854896,24,2088,2121,2107.423076923077,4.136410292740568,33,1
1946,1972,1957.0115384615385,4.815902464016121,26,2365,2389,2378.2615384615383,3.8755821008122924,24,2088,2121,2108.276923076923,4.614088522104111,33,1
1939,1969,1955.0692307692307,5.503510233353335,30,2368,2386,2378.35,2.9599319098920014,18,2098,2120,2108.257692307692,4.056423770339313,22,1
1939,1963,1952.4769230769232,4.280178585050947,24,2370,2385,2377.9423076923076,2.7185439375667886,15,2098,2118,2108.9615384615386,3.6926387090508372,20,1
1944,1963,1953.6538461538462,3.489004324037328,19,2368,2385,2377.173076923077,2.921899431448024,17,2103,2121,2111.519230769231,3.4590287242056426,18,1
1944,1963,1955.326923076923,3.6067351938475825,19,2368,2386,2377.1346153846152,3.1008085018287352,18,2102,2121,2111.6153846153848,3.581127311960973,19,1
1946,1964,1956.5576923076924,3.1830478918473535,18,2371,2386,2377.7153846153847,2.9137793138997146,15,2102,2121,2110.853846153846,3.285892481060419,19,1
1945,1967,1957.0807692307692,3.4007175294163607,22,2364,2385,2377.619230769231,2.8018911471707817,21,2100,2134,2111.3846153846152,4.062987879365444,34,1
1943,1976,1955.6153846153845,5.123018860527672,33,2362,2388,2377.496153846154,3.2697254993508005,26,2092,2135,2111.003846153846,4.9760027040389465,43,1
1943,1976,1955.3461538461538,4.646103591858299,33,2362,2388,2377.5,3.434438352244337,26,2092,2135,2111.326923076923,4.41356785714021,43,1
1951,1965,1956.7846153846153,2.816072500889196,14,2369,2386,2377.3307692307694,3.0640233008642066,17,2102,2121,2111.7615384615383,3.1945993184536934,19,1
1948,1965,1956.7730769230768,3.1090921209339903,17,2371,2386,2377.3076923076924,2.94045449654856,15,2103,2119,2111.2615384615383,2.823108848405171,16,1
1945,1967,1956.5230769230768,3.2978649571978047,22,2369,2386,2377.4115384615384,2.826355133079235,17,2105,2119,2111.4653846153847,2.690386475616354,14,1
1945,1967,1956.4384615384615,3.0160544584911757,22,2368,2384,2377.4,2.8585710716070314,16,2104,2120,2111.3192307692307,3.0189260447905086,16,1
1949,1962,1956.4038461538462,2.6131506995496028,13,2368,2385,2377.3346153846155,3.09806793792921,17,2104,2120,2111.0730769230768,3.040023584076839,16,1
1948,1962,1956.446153846154,2.590632183729506,14,2368,2385,2377.7923076923075,2.940060551069662,17,2104,2119,2110.973076923077,2.872322683863636,15,1
1947,1967,1956.5269230769231,2.938764704146623,20,2371,2385,2377.6884615384615,2.7040405806561894,14,2104,2119,2111.173076923077,2.921899431448024,15,1
1947,1977,1960.753846153846,6.315466751168934,30,2369,2385,2376.5384615384614,2.805548408262076,16,2105,2129,2114.376923076923,5.057606961734787,24,1
1950,1977,1966.0807692307692,4.548878196027328,27,2369,2383,2375.642307692308,2.6169440571774163,14,2107,2129,2118.1615384615384,4.129756125352398,22,1
1906,1978,1963.3961538461538,9.03835588156812,72,2351,2401,2375.507692307692,4.3580062634441665,50,2105,2132,2118.673076923077,4.013111492976971,27,1
1906,1978,1957.0923076923077,9.370903916583513,72,2351,2401,2375.6615384615384,5.353963416472348,50,2103,2138,2118.4423076923076,6.1525443195316845,35,1
1928,1974,1955.2807692307692,6.612409021979287,46,2359,2386,2375.6,4.6625096395606676,27,2101,2138,2118.6115384615387,6.486030544068708,37,1
1928,1976,1953.303846153846,7.297589424242187,48,2362,2386,2375.007692307692,4.089719956893054,24,2101,2139,2119.7115384615386,6.068898300476503,38,1
1935,1989,1953.5576923076924,8.87235405451487,54,2362,2386,2374.642307692308,3.914005450869821,24,2102,2139,2120.3038461538463,6.4115593468432674,37,1
1940,1991,1963.5115384615385,11.958255154907274,51,2367,2387,2374.9692307692308,3.7569774706377617,20,2102,2135,2119.876923076923,6.403444276645078,33,1
1950,1991,1970.4,9.155541394365395,41,2365,2387,2374.4538461538464,3.6052547202467675,22,2097,2135,2120.723076923077,6.69410549745434,38,1
1950,1987,1972.1423076923077,6.862053514639657,37,2365,2383,2373.473076923077,3.162773047996545,18,2097,2136,2122.9846153846156,5.584706938501928,39,1
1963,1981,1973.7115384615386,2.8780660230898163,18,2363,2381,2373.153846153846,2.803642249005722,18,2115,2136,2124.1961538461537,2.814054738078858,21,1
1963,1984,1973.376923076923,3.000039599778243,21,2363,2381,2373.1769230769232,2.70838932492593,18,2116,2132,2123.9384615384615,2.700647273061718,16,1
1965,1984,1973.4923076923078,3.1099445769587715,19,2365,2381,2373.0115384615383,2.683400557247939,16,2116,2132,2124.25,2.765444520810967,16,1
1961,1984,1972.95,3.4001760117965825,23,2365,2385,2374.130769230769,3.805885427172484,20,2106,2136,2120.9076923076923,5.813638808732118,30,1
1958,1984,1971.123076923077,4.113290230357751,26,2365,2385,2375.3153846153846,3.9102570107487677,20,2090,2136,2116.603846153846,6.345945762534346,46,1
1958,1987,1971.5461538461539,4.652581030622707,29,2364,2391,2374.7615384615383,3.5820311878803386,27,2090,2136,2118.5538461538463,6.336218789441267,46,1
1964,1990,1974.3192307692307,4.4921655723661305,26,2363,2391,2374.5153846153844,3.459048043177973,28,2109,2137,2121.2807692307692,4.7616971789226605,28,1
1955,1990,1972.3423076923077,6.0870565302334105,35,2363,2383,2374.873076923077,3.2637067885736917,20,2106,2137,2120.873076923077,4.686632406592533,31,1
1955,1986,1970.7846153846153,4.963938863512426,31,2366,2383,2374.4115384615384,3.10496263919439,17,2106,2133,2121.7923076923075,4.048349020172271,27,1
1965,1979,1972.6846153846154,2.820319583700144,14,2365,2380,2373.7615384615383,2.8415120401276983,15,2115,2134,2123.1615384615384,3.1642399738980944,19,1
1965,1982,1973.0230769230768,2.8609078252879074,17,2365,2380,2373.9346153846154,2.7055558892827682,15,2115,2134,2123.2653846153844,3.0330791861686284,19,1
1965,1982,1973.0230769230768,2.7815314373411524,17,2366,2380,2374.05,2.7609731930920614,14,2116,2135,2123.253846153846,3.07389441081291,19,1
1967,1981,1973.0846153846153,2.7213856775437044,14,2366,2380,2373.8653846153848,2.9632813789845422,14,2115,2135,2123.2384615384617,3.176418531874332,20,1
1965,1981,1973.0846153846153,2.780335290979189,16,2366,2381,2373.769230769231,2.919878512145758,15,2115,2133,2123.3,2.967390335868439,18,1
1964,1982,1973.053846153846,2.856440365078809,18,2366,2381,2373.6769230769232,2.651481365266109,15,2113,2135,2123.0923076923077,2.994064021429629,22,1
1964,1982,1973.1461538461538,3.125709898577021,18,2367,2380,2373.4461538461537,2.7398434091644557,13,2113,2135,2123.0307692307692,2.9590211820475965,22,1
1963,1985,1972.8192307692307,3.4866008527483485,22,2365,2382,2373.7153846153847,2.899166743250171,17,2111,2142,2122.976923076923,3.4315488012743134,31,1
1963,1985,1972.9923076923078,3.724065851816596,22,2365,2382,2373.753846153846,2.7143591817859636,17,2111,2142,2123.2115384615386,3.613234673456016,31,1
1954,2003,1973.0961538461538,5.2595183631710425,49,2357,2398,2373.646153846154,3.8451926330817785,41,2102,2139,2122.5846153846155,4.112856977283858,37,1
1954,2007,1981.1307692307691,11.805298503852953,53,2357,2398,2371.9461538461537,5.129687291998579,41,2102,2146,2126.392307692308,7.9067891787574,44,1
1948,2007,1979.2884615384614,14.545543624177107,59,2358,2388,2372.2923076923075,5.56803640460705,30,2090,2146,2125.269230769231,10.007169986737068,56,1
1948,1995,1973.7923076923078,9.567638629239138,47,2361,2388,2373.6692307692306,4.699278613065997,27,2090,2140,2122.0730769230768,7.6029895406642485,50,1
1969,1995,1978.6653846153847,3.971854872176365,26,2363,2386,2373.0153846153844,3.3874276191035984,23,2099,2139,2123.9192307692306,4.529314149480764,40,1
1969,1998,1978.8076923076924,4.009826065891771,29,2363,2389,2373.146153846154,3.558906470506813,26,2111,2140,2123.757692307692,4.18017688906568,29,1
1969,1998,1977.9038461538462,4.59670696039185,29,2360,2389,2373.2115384615386,3.7598598227255606,29,2108,2141,2124.2961538461536,4.679783248225419,33,1
1957,1990,1974.0076923076922,5.4595687015450585,33,2355,2387,2374.096153846154,4.070136154480378,32,2104,2141,2121.35,6.159134848738262,37,1
1957,1983,1973.15,4.56491149842108,26,2355,2387,2374.5923076923077,3.8065096728520067,32,2104,2133,2120.003846153846,5.428011202393157,29,1
1967,1983,1974.9692307692308,3.0489911276267923,16,2365,2385,2374.642307692308,3.033744971748376,20,2109,2131,2120.2961538461536,3.7044250664259732,22,1
1964,1985,1974.7615384615385,3.469233436305582,21,2367,2384,2374.857692307692,3.0854838956330446,17,2110,2133,2119.6692307692306,3.7455527534885196,23,1
1958,1992,1974.7653846153846,4.481919258264281,34,2364,2397,2374.4269230769232,3.743520290307529,33,2108,2141,2121.5423076923075,4.716902415692782,33,1
1958,1992,1975.7076923076922,4.353042079853507,34,2364,2397,2373.8653846153848,3.592295735958922,33,2108,2141,2123.75,4.115490090773964,33,1
1968,1987,1976.3076923076924,3.0639166743867867,19,2366,2381,2373.4615384615386,2.773715142817606,15,2117,2133,2124.7192307692308,2.92275313574135,16,1
1963,1983,1975.623076923077,3.238917271340083,20,2365,2383,2373.35,2.929776567178926,18,2118,2133,2125.0576923076924,2.9132466831708976,15,1
1963,1988,1976.3384615384616,4.04616954309727,25,2362,2387,2373.5384615384614,3.789140846892387,25,2100,2136,2123.642307692308,5.29140580082225,36,1
1967,1988,1975.2961538461539,4.259078948523201,21,2362,2387,2374.0692307692307,3.6638449781288536,25,2100,2136,2122.0307692307692,5.180060466155432,36,1
1967,1988,1974.8961538461538,3.845569156627162,21,2366,2382,2374.0346153846153,2.870895399007144,16,2111,2136,2122.3192307692307,3.3786199497831606,25,1
1967,1988,1975.9346153846154,3.5280937909083137,21,2366,2387,2373.9153846153845,3.15869729118961,21,2110,2132,2122.496153846154,3.33982414273945,22,1
1967,1989,1975.7115384615386,3.4109552012032323,22,2366,2387,2373.896153846154,3.283394604777216,21,2110,2136,2122.7615384615383,3.7360889387647824,26,1
1966,1989,1975.5,3.517743221799649,23,2366,2384,2373.6769230769232,3.0204333336489193,18,2112,2136,2123.269230769231,3.5647100453133227,24,1
1963,1988,1975.373076923077,4.11458069306877,25,2363,2384,2373.857692307692,3.27959328358443,21,2112,2133,2123.0307692307692,3.8743557671737645,21,1
1963,1999,1978.7961538461539,5.985889506236578,36,2363,2388,2373.6807692307693,3.9594975726247177,25,2106,2135,2122.7192307692308,4.903116905658623,29,1
1965,2012,1982.4076923076923,7.2091706438494985,47,2360,2389,2373.0576923076924,4.656599342215028,29,2106,2147,2124.126923076923,6.322971400375565,41,1
1965,2012,1982.4115384615384,6.669519610323657,47,2360,2389,2372.496153846154,4.379222685316576,29,2106,2147,2125.1384615384613,5.843194036048825,41,1
1973,1992,1981.8307692307692,3.5988811250089032,19,2363,2383,2372.75,3.381045279416882,20,2113,2137,2124.5,4.076015163600304,24,1
1963,1990,1979.5,5.010799148649655,27,2366,2385,2373.9076923076923,3.2760889995174325,19,2109,2134,2122.4692307692308,4.62273793002653,25,1
1963,1988,1975.8961538461538,4.775337281684525,25,2366,2385,2375.0423076923075,3.2002259906835318,19,2108,2133,2119.5115384615383,4.645322047933483,25,1
1962,1984,1973.5269230769231,4.190820792276725,22,2365,2385,2375.4307692307693,3.5984519656175142,20,2104,2133,2117.892307692308,4.475150011671969,29,1
1953,1984,1971.8461538461538,4.589666988469105,31,2365,2386,2375.4692307692308,3.8054796125685764,21,2102,2135,2117.1,5.007099207229919,33,1
1951,1988,1971.073076923077,6.450168815982861,37,2364,2390,2375.6384615384613,4.078389882449204,26,2101,2135,2116.3884615384613,5.898682983892332,34,1
1951,1988,1970.7192307692308,5.947162408976293,37,2364,2390,2375.4692307692308,3.7892113900022735,26,2101,2135,2117.25,5.424365877569946,34,1
1962,1977,1969.9730769230769,2.769672728155264,15,2368,2383,2375.153846153846,2.639063653013501,15,2108,2129,2118.25,3.106072020685193,21,1
1962,1978,1969.8692307692309,2.810318718204627,16,2368,2381,2374.9269230769232,2.6330330576852017,13,2111,2127,2118.223076923077,3.091313985382617,16,1
1958,1983,1970.446153846154,3.347474212833253,25,2367,2382,2374.673076923077,2.89268251241164,15,2106,2130,2118.5153846153844,3.500103948560336,24,1
1958,1983,1970.626923076923,3.3083558295954645,25,2366,2383,2374.5692307692307,3.16090613453288,17,2106,2130,2118.7615384615383,3.63446362058087,24,1
1962,1978,1970.6384615384616,2.9967906801701023,16,2366,2383,2374.896153846154,3.0467377032837324,17,2109,2127,2118.75,3.494479927169415,18,1
1961,1979,1970.323076923077,2.9740587157998823,18,2365,2385,2375.1346153846152,3.0644861137024493,20,2109,2130,2118.9192307692306,3.3653376465813167,21,1
1961,1979,1970.2076923076922,3.0331403857949937,18,2365,2385,2374.8884615384613,3.27607766737678,20,2108,2130,2118.8038461538463,3.469111440229931,22,1
1962,1977,1969.7692307692307,3.0492443814642503,15,2365,2383,2375.0807692307694,3.072674338638508,18,2108,2127,2118.8423076923077,3.2278557230849967,19,1
1962,1978,1969.253846153846,2.8712703885551503,16,2365,2383,2375.1653846153845,2.8256194602467852,18,2111,2127,2119.0846153846155,2.993002432017649,16,1
1961,1979,1969.35,3.0863693355908777,18,2365,2385,2375.3653846153848,2.867935141360762,20,2110,2127,2119.0,3.146365188533254,17,1
1961,1979,1969.2653846153846,3.154140786110236,18,2366,2385,2375.526923076923,2.82761584120109,19,2110,2127,2118.9615384615386,3.105366748598729,17,1
1962,1975,1968.6923076923076,2.8429854172271236,13,2366,2388,2375.7115384615386,2.943066837780347,22,2110,2126,2118.9,2.7420647182221862,16,1
1961,1976,1968.173076923077,2.7079259744060735,15,2369,2388,2375.8615384615387,2.929687864444092,19,2111,2126,2118.3423076923077,2.715986289836811,15,1
1960,1976,1967.8884615384616,2.952497394959201,16,2368,2382,2375.5730769230768,2.7351646442445894,14,2111,2125,2117.5461538461536,2.680147343559638,14,1
1959,1976,1967.7730769230768,3.0627992965161024,17,2367,2382,2375.5653846153846,2.85552263237564,15,2109,2125,2117.0615384615385,2.7878773596161244,16,1
1959,1978,1968.1884615384615,3.0312181277967016,19,2367,2383,2375.6961538461537,3.037091268619265,16,2107,2127,2116.976923076923,3.066736181165704,20,1
1959,1980,1969.173076923077,3.7577264230526244,21,2367,2383,2374.996153846154,3.187206662312048,16,2107,2133,2120.0807692307694,5.008604120522527,26,1
1959,1980,1970.0346153846153,3.9174337896494813,21,2364,2383,2374.003846153846,2.955915575153811,19,2109,2133,2122.369230769231,4.191623309614781,24,1
1960,1980,1969.0115384615385,3.6396388003441493,20,2364,2385,2374.4192307692306,3.0814577143588466,21,2109,2131,2120.3615384615387,3.8645080326507713,22,1
1952,1977,1967.246153846154,3.6919228093628975,25,2367,2385,2375.1115384615387,3.0641565787432503,18,2107,2129,2118.519230769231,3.7544844980574696,22,1
1950,1980,1963.7076923076922,5.213505114664757,30,2367,2387,2375.496153846154,3.048511348744079,20,2102,2125,2116.7153846153847,4.092057690812306,23,1
1947,1980,1963.2076923076922,6.504166949286258,33,2367,2387,2375.9115384615384,3.23289402882368,20,2099,2128,2115.603846153846,4.7558929727778745,29,1
1947,1980,1964.0076923076922,5.953482681922913,33,2368,2384,2375.9692307692308,3.0439216260375144,16,2099,2130,2116.246153846154,4.563683296111292,31,1
1954,1975,1963.3961538461538,3.6508824520850682,21,2368,2382,2375.6769230769232,2.7204797005325734,14,2107,2130,2117.0538461538463,3.4759216737480556,23,1
1957,1972,1964.6346153846155,2.9173217616105123,15,2365,2382,2375.146153846154,2.9345802445598945,17,2108,2126,2117.619230769231,3.1520685407421083,18,1
1956,1972,1964.7730769230768,2.7730163792556004,16,2365,2382,2375.0846153846155,2.970991320551009,17,2108,2125,2117.9538461538464,2.836228771484001,17,1
1956,1972,1964.5653846153846,3.069270071274076,16,2367,2381,2375.3230769230768,2.6427299112889653,14,2111,2125,2117.923076923077,2.6012037148713993,14,1
1956,1973,1964.4807692307693,3.083712252996582,17,2368,2382,2375.4269230769232,2.679546105213965,14,2110,2126,2117.4346153846154,2.8730463978842398,16,1
1955,1991,1966.626923076923,6.466668784451944,36,2361,2383,2375.023076923077,3.5017158168551688,22,2100,2148,2118.253846153846,5.368737675035374,48,1
1950,1991,1969.6653846153847,7.162722153943196,41,2361,2389,2374.5538461538463,4.3859402226286255,28,2100,2148,2119.873076923077,7.022526231056362,48,1
1942,1986,1962.65,9.460168478668212,44,2362,2392,2377.6884615384615,5.37180016439899,30,2075,2141,2108.726923076923,13.386100602404323,66,1
1936,1963,1952.9769230769232,4.406848626889154,27,2371,2392,2381.1846153846154,3.5353364901525426,21,2075,2116,2094.9153846153845,5.69702844087451,41,1
1936,1963,1951.3884615384616,3.6145167332205306,27,2374,2393,2381.6115384615387,2.945951599845257,19,2076,2114,2093.2076923076925,4.0512091790347995,38,1
1944,1959,1951.4384615384615,2.8023813540168394,15,2374,2393,2381.6692307692306,2.8485272535307633,19,2084,2106,2093.7807692307692,3.424025857664202,22,1
1943,1958,1950.6807692307693,2.999680707689462,15,2374,2388,2381.8076923076924,2.5562283807014454,14,2082,2101,2092.9,3.479337797022805,19,1
1940,1967,1952.503846153846,5.341249168400841,27,2375,2397,2381.576923076923,3.118918198294198,22,2082,2110,2094.5538461538463,4.821223251851509,28,1
1939,1989,1959.2423076923078,10.27906644638544,50,2370,2397,2380.476923076923,3.733838553225131,27,2081,2126,2098.2653846153844,7.073985311779222,45,1
1939,1989,1962.05,8.858900373642083,50,2370,2388,2380.9538461538464,3.3871470403224415,18,2081,2126,2094.976923076923,8.039924877782878,45,1
1951,1968,1960.926923076923,3.1657015291505566,17,2375,2388,2381.9346153846154,2.53613914878537,13,2082,2099,2091.7807692307692,3.4766201168501913,17,1
1953,1968,1960.6653846153847,2.914408661079953,15,2372,2388,2381.526923076923,2.6890393416483485,16,2086,2101,2093.5307692307692,2.8493404006437557,15,1
1950,1967,1959.9923076923078,3.045336085569518,17,2372,2389,2381.6346153846152,2.958064992549775,17,2086,2101,2093.8038461538463,2.9031976471739878,15,1
1950,1967,1959.6461538461538,3.2676288463346443,17,2370,2389,2381.526923076923,2.9818055337604163,19,2085,2107,2094.019230769231,3.2602104807776415,22,1
1951,1968,1959.7384615384615,3.0416766514205373,17,2370,2389,2381.1692307692306,2.641043614768862,19,2085,2107,2094.876923076923,3.235935733490403,22,1
1953,1968,1960.3692307692309,2.7903265375081436,15,2374,2388,2380.9423076923076,2.5133885627021675,14,2089,2103,2095.4384615384615,2.8379770002791522,14,1
1953,1978,1963.7153846153847,5.457784091314641,25,2372,2389,2380.126923076923,2.9597111531178357,17,2087,2110,2097.923076923077,4.846071345369101,23,1
1953,1978,1967.0923076923077,4.633179239609652,25,2372,2389,2379.6115384615387,2.9979178003259426,17,2087,2110,2099.9884615384617,4.259427601535621,23,1
1957,1991,1967.8423076923077,3.4240432056374335,34,2370,2387,2379.7076923076925,2.9603457844730174,17,2090,2115,2100.1769230769232,3.5379146282577136,25,1
1957,1991,1968.4653846153847,4.204561074396925,34,2370,2390,2379.603846153846,3.3795867752739785,20,2090,2115,2101.607692307692,3.9816105351003945,25,1
1931,2005,1968.946153846154,10.667535666512542,74,2341,2399,2378.146153846154,6.603627806584817,58,2083,2173,2105.9461538461537,12.297980835906872,90,1
1931,2007,1972.803846153846,12.36525774295057,76,2341,2399,2368.8846153846152,10.317458768997113,58,2083,2174,2132.357692307692,26.225907098672547,91,1
1933,2007,1977.6346153846155,6.441985970893079,74,2349,2371,2360.9384615384615,3.6012735759966046,22,2135,2174,2155.273076923077,4.73368424778909,39,1
1970,1988,1978.4192307692308,3.170388966888164,18,2353,2369,2361.4692307692308,2.995977899765547,16,2144,2163,2154.423076923077,3.2876635790074094,19,1
1953,2000,1978.15,6.290014762644498,47,2343,2377,2360.6115384615387,5.673131616173058,34,2135,2199,2155.923076923077,8.865895251135026,64,1
1953,2002,1978.3615384615384,8.086887089464202,49,2343,2377,2362.4423076923076,7.046490573542932,34,2127,2199,2151.723076923077,12.083694866044972,72,1
1955,2002,1979.3538461538462,6.368796445292325,47,2347,2377,2363.392307692308,5.011948894355539,30,2127,2174,2149.6769230769232,8.697592428259332,47,1
1969,1989,1980.0807692307692,3.71644776123437,20,2352,2371,2361.8846153846152,3.3545557460033737,19,2138,2167,2152.5307692307692,5.127996382247837,29,1
1971,1988,1979.3,3.1663042534605905,17,2354,2374,2363.003846153846,3.1198679272648517,20,2143,2159,2150.7038461538464,3.1575099872952612,16,1
1955,2022,1980.3961538461538,6.709123665751017,67,2326,2375,2362.5153846153844,5.175282232260013,49,2137,2176,2151.65,6.204105627802177,39,1
1954,2022,1981.0346153846153,9.499581064028055,68,2326,2382,2364.023076923077,7.327912874639483,56,2123,2176,2148.2923076923075,10.842463463577545,53,1
1950,2009,1977.6038461538462,9.842425728617119,59,2344,2382,2365.3423076923077,6.747095647261841,38,2123,2171,2145.2192307692308,9.931523044586362,48,1
1944,2008,1975.2,10.653837200945352,64,2348,2382,2364.523076923077,6.091598600332552,34,2121,2166,2146.0730769230768,9.082549677414853,45,1
1944,2008,1972.7769230769231,9.332357777802011,64,2348,2382,2366.2615384615383,5.198832429292046,34,2121,2166,2142.423076923077,7.984410858091958,45,1
1961,1983,1969.823076923077,3.5400965992870774,22,2360,2376,2367.5846153846155,2.826473348353313,16,2130,2148,2139.7192307692308,3.366025947631818,18,1
1961,1977,1969.4653846153847,2.962238836565837,16,2358,2378,2367.603846153846,3.1818720078452984,20,2128,2147,2139.5807692307694,3.550683139531147,19,1
1956,1984,1969.2961538461539,3.5522553354901127,28,2358,2378,2368.0384615384614,3.3517213837125888,20,2128,2149,2138.619230769231,3.7649592726772387,21,1
1956,1997,1972.1807692307693,7.01969206063034,41,2350,2383,2366.35,5.398108491830754,33,2128,2169,2141.9,7.5263757577157975,41,1
1957,1997,1972.9923076923078,6.4616434715044715,40,2350,2383,2365.6884615384615,5.182300358550921,33,2129,2169,2143.2346153846156,6.783095175536029,40,1
1960,1979,1969.7153846153847,3.1432580676857063,19,2359,2377,2367.5423076923075,3.0482190606384316,18,2131,2149,2139.2961538461536,3.4046278712204274,18,1
1958,1975,1967.9153846153847,3.3646690655988625,17,2360,2378,2368.5307692307692,2.8977116828168046,18,2127,2146,2136.9076923076923,3.4839868739942945,19,1
1958,1975,1966.8923076923077,3.355963179549034,17,2360,2378,2368.9576923076925,2.847836417382898,18,2127,2148,2136.130769230769,3.376933935344724,21,1
1959,1978,1967.446153846154,3.435138745404354,19,2358,2376,2369.1153846153848,3.0291622894497046,18,2123,2148,2135.8230769230768,3.3610657084863274,25,1
1959,1978,1967.8307692307692,3.2576336522354703,19,2358,2376,2369.3384615384616,2.8624957281857726,18,2123,2144,2135.4346153846154,3.250119369081067,21,1
1961,1975,1967.503846153846,2.686298822953501,14,2362,2377,2369.3384615384616,2.440184327975974,15,2128,2143,2135.3038461538463,2.78647876619649,15,1
1954,1977,1967.4384615384615,2.9078613886596894,23,2362,2377,2369.107692307692,2.5581911860418374,15,2128,2143,2135.0,2.863699041584538,15,1
1954,1977,1967.4307692307693,3.1079384259153624,23,2360,2375,2369.130769230769,2.868786787117096,15,2127,2143,2135.05,3.19770067005803,16,1
1959,1975,1967.2961538461539,2.9839960211488648,16,2360,2378,2369.35,2.8926414429331744,18,2127,2143,2135.153846153846,3.026170378168942,16,1
1959,1974,1967.2269230769232,2.9823234305241013,15,2360,2378,2369.396153846154,2.801127843622493,18,2126,2142,2135.126923076923,2.85749812166089,16,1
1960,1975,1967.1384615384616,3.0025827907825318,15,2362,2377,2369.376923076923,2.6834697317111296,15,2126,2144,2135.0884615384616,2.9401792453273994,18,1
1956,1979,1967.1692307692308,3.258818654036922,23,2362,2376,2369.492307692308,2.568734357304429,14,2125,2146,2135.269230769231,3.338759072965905,21,1
1956,1979,1967.4692307692308,3.2208022251555546,23,2361,2376,2369.0423076923075,2.819221541136861,15,2125,2147,2135.3653846153848,3.453099140466962,22,1
1959,1976,1967.6,2.927963963742207,17,2361,2376,2368.7076923076925,2.8513930859217798,15,2128,2147,2135.4153846153845,3.145836533624641,19,1
1961,1974,1967.35,2.7893551101467753,13,2362,2379,2368.9846153846156,2.9864161328725305,17,2127,2143,2135.6769230769232,3.0899397967805045,16,1
1959,1975,1966.9730769230769,2.8682872201143974,16,2359,2379,2368.8384615384616,3.1038743908277335,20,2127,2143,2135.5461538461536,3.1096103083306548,16,1
1958,1975,1966.9423076923076,3.0932325030762424,17,2359,2378,2369.0346153846153,2.9674478859361546,19,2128,2143,2134.9538461538464,3.0689918570616994,15,1
1958,1974,1967.1423076923077,2.9196013210833898,16,2361,2378,2369.45,2.659832781343674,17,2128,2143,2134.6384615384613,2.947425671211759,15,1
1955,1974,1967.1307692307691,3.1497709950181014,19,2360,2377,2369.5346153846153,2.8097241936798785,17,2124,2149,2134.2653846153844,3.1258595491477092,25,1
1949,1974,1965.7769230769231,4.01015195239765,25,2360,2377,2369.5692307692307,3.0578425319824682,17,2120,2149,2133.5384615384614,3.5611673201230913,29,1
1949,1973,1964.7923076923078,3.5764052050451713,24,2361,2377,2369.5538461538463,2.8066703186156863,16,2120,2146,2133.8076923076924,3.5523577549629795,26,1
1957,1973,1965.2884615384614,2.8402548859297503,16,2357,2378,2369.6153846153848,2.863387888322188,21,2125,2146,2133.9653846153847,3.1712319698678946,21,1
1959,1973,1965.5384615384614,2.8110478299007826,14,2357,2378,2369.869230769231,2.9667096590947692,21,2122,2142,2133.1692307692306,3.1195942255152564,20,1
1958,1973,1965.3961538461538,2.8745966000998497,15,2357,2377,2369.9884615384617,3.1297337179436124,20,2122,2142,2132.673076923077,2.898016588720663,20,1
1958,1979,1965.2615384615385,3.071990403162913,21,2357,2378,2370.026923076923,3.362759678917401,21,2125,2142,2132.4384615384615,2.7719049557041244,17,1
1957,1979,1965.0807692307692,3.32261691890341,22,2360,2378,2370.153846153846,3.142587130988396,18,2122,2143,2132.473076923077,3.1147993598264168,21,1
1957,1973,1965.176923076923,3.041452062819773,16,2360,2378,2370.4192307692306,2.873997287726697,18,2122,2143,2132.346153846154,3.162794176557653,21,1
1890,1972,1964.956204379562,7.0103585260530155,82,2362,2378,2370.7737226277372,2.7891404451011295,16,2052,2141,2131.5036496350367,7.512855734546383,89,1
1833,1989,1888.5576923076924,28.83611893566392,156,2351,2420,2381.35,9.218738261559178,69,2005,2085,2047.2576923076922,15.56921705643928,80,2
1820,1969,1889.4153846153847,16.88287364850613,149,2310,2472,2380.9884615384617,15.788780213670107,162,1991,2176,2053.7846153846153,31.127210560910164,185,2
1820,1983,1890.823076923077,25.753349037260893,163,2286,2472,2374.1384615384613,26.62371974804522,186,1991,2266,2087.6961538461537,45.45373973824878,275,2
1801,2011,1895.7615384615385,33.09838005254581,210,2280,2452,2364.226923076923,29.739253698995388,172,2019,2266,2116.0923076923077,39.27331143146693,247,2
1786,2011,1887.7615384615385,38.81583163180695,225,2244,2619,2375.119230769231,72.65189929002868,375,1915,2236,2078.523076923077,63.1748465883475,321,2
1786,1990,1888.5384615384614,40.45143975582301,204,2244,2631,2387.123076923077,84.9086281898085,387,1915,2205,2045.376923076923,48.87755805700282,290,2
1788,1990,1904.4391891891892,37.78910802139155,202,2247,2631,2375.9864864864867,72.97152426500107,384,1951,2193,2050.6554054054054,43.17323321018387,242,2
1875,1918,1890.3,7.4061958826200005,43,2371,2396,2383.5346153846153,3.8917239490379187,25,2021,2063,2035.2230769230769,7.293372868110323,42,3
1875,1918,1893.25,6.951778195341109,43,2371,2396,2384.15,4.012119670087651,25,2024,2063,2035.4884615384615,7.270548136892446,39,3
1876,1907,1893.003846153846,5.1708255518279564,31,2375,2394,2384.4576923076925,3.7066852968003485,19,2022,2049,2032.8346153846153,4.287851412499007,27,3
1876,1907,1891.126923076923,5.666678168137085,31,2375,2395,2384.0730769230768,3.777402602155404,20,2022,2049,2030.55,4.323032504921752,27,3
1876,1907,1890.7615384615385,4.243193679846891,31,2375,2395,2384.269230769231,3.0700658666068428,20,2021,2038,2028.4423076923076,3.0857341544201877,17,3
1884,1910,1892.173076923077,4.208472580550034,26,2377,2394,2385.0115384615383,2.9124717736815637,17,2013,2038,2027.0692307692307,4.097628020032491,25,3
1884,1910,1895.1076923076923,5.107714135378338,26,2377,2394,2385.3307692307694,3.106571591125344,17,2011,2036,2023.65,5.472694592281402,25,3
1888,1908,1897.7923076923078,3.701603855340426,20,2378,2393,2385.626923076923,2.916344262096616,15,2011,2037,2025.2307692307693,5.787135862492041,26,3
1888,1908,1898.1384615384616,3.6311689006967973,20,2378,2394,2385.8423076923077,2.9055496196448947,16,2017,2037,2027.7730769230768,3.3297602372097663,20,3
1889,1908,1897.8423076923077,3.2882936247961436,19,2379,2394,2385.7,2.8492361639826767,15,2016,2036,2026.1653846153847,3.32760100116111,20,3
1890,1910,1897.3538461538462,3.3619757439459472,20,2379,2394,2385.6807692307693,2.5803712927243647,15,2016,2039,2027.4076923076923,3.7047317210612056,23,3
1890,1910,1898.8538461538462,3.6888887497321208,20,2377,2393,2385.5576923076924,2.7242190020938426,16,2023,2051,2033.6884615384615,6.571779312962612,28,3
1893,1938,1908.3923076923077,12.23640757451591,45,2364,2400,2385.75,4.6235714688337115,36,2026,2081,2042.2192307692308,9.919853313103463,55,3
1892,1941,1920.4,11.50564742984604,49,2364,2413,2386.1923076923076,7.232056644042778,49,2024,2084,2052.5923076923077,13.958679315921268,60,3
1892,1941,1918.8576923076923,8.677787428486289,49,2364,2413,2386.526923076923,6.3217500199330345,49,2024,2084,2049.742307692308,13.514433099094537,60,3
1904,1925,1913.15,3.4097011270875015,21,2378,2395,2387.142307692308,2.8486497616950848,17,2026,2051,2037.35,5.0323854656517994,25,3
1895,1925,1909.9,5.185888187517765,30,2379,2395,2386.869230769231,2.9339931847766807,16,2026,2058,2036.4923076923078,5.492355029125827,32,3
1895,1917,1905.1,4.805643400649751,22,2379,2393,2385.9076923076923,2.850038687933994,14,2028,2058,2040.2730769230768,5.763555965597746,30,3
1894,1915,1902.2769230769231,3.4985168056792073,21,2377,2392,2385.5,2.822277620159109,15,2029,2054,2039.2307692307693,4.933595275289851,25,3
1893,1942,1910.503846153846,12.089913494976228,49,2370,2402,2385.6346153846152,4.632555796811649,32,2023,2091,2047.0423076923078,16.420221855190803,68,3
1887,1942,1915.6692307692308,10.912348898351741,55,2351,2413,2385.6,7.229390891637599,62,2016,2091,2048.3230769230768,15.950558448540752,75,3
1886,1932,1906.5807692307692,10.041862924229298,46,2351,2413,2385.7884615384614,6.317642571609102,62,2016,2051,2036.823076923077,5.350228782486598,35,3
1886,1917,1900.0307692307692,5.994770515814057,31,2378,2394,2385.8076923076924,2.9892888679162364,16,2021,2045,2032.6846153846154,4.055664069965737,24,3
1889,1910,1897.9076923076923,3.339123769755705,21,2377,2393,2385.4192307692306,2.9325123613769732,16,2020,2039,2030.5230769230768,3.3328026505590618,19,3
1887,1910,1895.6748971193415,3.560177398558469,23,2377,2392,2385.0699588477364,2.9400418136598137,15,2020,2038,2030.008230452675,3.206387954578664,18,3
1886,1904,1895.3653846153845,3.2348777742650827,18,2378,2392,2385.496153846154,2.6222953736055414,14,2017,2034,2026.1576923076923,3.176004760230412,17,4
1862,1980,1902.1923076923076,21.184461470176856,118,2330,2555,2388.423076923077,21.349044587093466,225,1978,2150,2025.4423076923076,16.51442970484868,172,4
1786,2040,1899.3384615384616,41.5476753358034,254,2257,2555,2379.8076923076924,51.80742424604033,298,1969,2235,2061.8192307692307,51.36524161082128,266,4
1780,2040,1890.6038461538462,50.717332950361865,260,2227,2638,2372.0423076923075,74.17319122036139,411,1969,2235,2097.5923076923077,46.18875093354131,266,4
1775,2024,1882.7346153846154,46.49634387841687,249,2191,2638,2377.642307692308,87.6259982976832,447,1948,2229,2071.576923076923,53.12814920172015,281,4
1775,2016,1884.2961538461539,44.16895414481206,241,2191,2619,2381.619230769231,84.906428256355,428,1894,2201,2030.4807692307693,52.340543054905794,307,4
1787,2012,1911.7846153846153,40.92256264038377,225,2259,2603,2384.5,62.818516562921346,344,1894,2153,2013.6384615384616,45.720403232640805,259,4
1837,2036,1922.423076923077,30.387552162083185,199,2263,2605,2389.2076923076925,55.46541531271803,342,1934,2151,2015.8653846153845,38.51702168276981,217,4
1813,2036,1912.1692307692308,36.38248941572767,223,2231,2605,2392.8192307692307,65.89211094752,374,1934,2164,2029.4423076923076,42.591810196472,230,4
1786,2030,1889.7192307692308,43.40713710358645,244,2218,2591,2385.746153846154,75.58608189776591,373,1972,2164,2046.426923076923,42.254405611542964,192,4
1783,2030,1867.6153846153845,42.48004475697033,247,2218,2591,2380.103846153846,77.5470512585434,373,1973,2164,2049.2115384615386,40.01550690658301,191,4
1783,2028,1867.3692307692309,41.953575824982124,245,2261,2579,2379.5846153846155,71.65778654436915,318,1968,2171,2041.9538461538461,41.90610234466353,203,4
1777,2005,1872.5846153846153,41.0246718527242,228,2269,2582,2384.2192307692308,74.99926650467974,313,1960,2171,2040.126923076923,43.70031371818077,211,4
1776,2005,1872.2192307692308,40.97350607622199,229,2221,2582,2382.4423076923076,72.91096105359085,361,1960,2198,2049.3230769230768,40.58476336660124,238,4
1776,2003,1872.7923076923078,40.35512170636892,227,2219,2564,2377.503846153846,61.33832363653205,345,1946,2235,2055.119230769231,38.5824746582869,289,4
1762,2033,1878.8,46.11231880903352,271,2219,2619,2380.1384615384613,53.63580228913601,400,1878,2235,2063.0730769230768,46.41318593173526,357,4
1730,2033,1874.6307692307691,50.293522762264644,303,2284,2623,2379.0653846153846,61.011926439059174,339,1878,2187,2061.3076923076924,49.12042504718538,309,4
1730,2016,1873.3846153846155,43.99067725302356,286,2284,2623,2378.6807692307693,61.62298196892055,339,1952,2187,2042.4653846153847,38.97334444298535,235,4
1747,2027,1883.1807692307693,38.467682060563035,280,2261,2573,2382.6807692307693,64.47466665545966,312,1962,2164,2039.7346153846154,36.48677173215673,202,4
1757,2027,1877.3423076923077,43.682185594168,270,2261,2594,2379.6153846153848,73.60825921169325,333,1916,2188,2047.426923076923,43.79469527380382,272,4
1753,2027,1874.5461538461539,50.9364979079522,274,2253,2600,2375.3884615384613,80.51115094317946,347,1903,2239,2050.242307692308,53.388563791216036,336,4
1753,2046,1888.1692307692308,50.54744908939134,293,2253,2600,2382.892307692308,81.60302687188751,347,1903,2239,2049.5461538461536,58.5865839846276,336,4
1754,2048,1887.6115384615384,45.053283142833465,294,2210,2628,2381.226923076923,74.95299972717682,418,1929,2223,2056.653846153846,51.4814824509069,294,4
1754,2048,1888.5076923076922,45.85595141710921,294,2210,2661,2381.269230769231,72.39875513142297,451,1901,2200,2057.15,49.63337205572095,299,4
1794,2016,1889.073076923077,39.567332355413974,222,2280,2661,2380.8076923076924,61.10420192362791,381,1901,2200,2038.1807692307693,46.75709447320143,299,4
1794,2013,1877.7423076923078,34.35886776193002,219,2290,2568,2379.2615384615383,61.60197984159211,278,1938,2158,2031.8423076923077,38.62824174475276,220,4
1785,1980,1879.3307692307692,38.37005115530634,195,2263,2574,2382.3653846153848,69.86275261220533,311,1897,2167,2034.65,45.62627900571485,270,4
1757,2059,1888.7038461538461,45.95449302478953,302,2239,2603,2382.026923076923,82.58812566070561,364,1897,2236,2054.3384615384616,60.44251921369698,339,4
1757,2065,1892.0,51.82425007419688,308,2239,2607,2372.0115384615383,93.84475320542809,368,1965,2248,2090.0615384615385,63.035842454253235,283,4
1762,2065,1895.3,51.47974823913262,303,2183,2607,2360.9,88.11074551326571,424,1973,2248,2104.4653846153847,55.922750374995054,275,4
1747,2038,1894.1807692307693,49.7193864540522,291,2183,2607,2370.3115384615385,84.50938960841529,424,1973,2232,2104.630769230769,48.10399584644104,259,4
1747,2020,1892.6615384615384,44.29491439927886,273,2235,2586,2376.0692307692307,83.07541240417736,351,1988,2232,2102.9653846153847,44.0148574626532,244,4
1773,2020,1892.326923076923,38.59457678601175,247,2215,2586,2374.0115384615383,75.72978189820611,371,2019,2231,2091.5153846153844,39.10933779726145,212,4
1773,1993,1885.1846153846154,37.52317885772675,220,2215,2548,2374.1615384615384,64.26192827946751,333,1990,2174,2071.0153846153844,35.43812588527738,184,4
1784,2017,1882.2961538461539,39.563847824093834,233,2288,2581,2378.7961538461536,65.82579666350804,293,1938,2159,2056.8153846153846,37.194736335245224,221,4
1761,2017,1879.6576923076923,39.208113897842566,256,2258,2581,2381.6576923076923,65.08973712363478,323,1938,2157,2044.5961538461538,37.56665099530789,219,4
1743,2008,1872.6461538461538,42.41536866117632,265,2249,2594,2380.7346153846156,66.62268238919692,345,1933,2137,2041.3615384615384,37.41265324868878,204,4
1743,2029,1871.746153846154,48.29611230642135,286,2233,2594,2380.5576923076924,76.50669677240451,361,1933,2141,2046.626923076923,39.41839777515168,208,4
1749,2029,1874.0807692307692,47.48807222100096,280,2233,2593,2381.0346153846153,82.21313032082404,360,1939,2181,2050.0538461538463,43.72109066496133,242,4
1726,2014,1873.0384615384614,48.49191372245167,288,2258,2589,2379.5153846153844,83.5549189026264,331,1914,2184,2051.880769230769,47.532118945533355,270,4
1726,2048,1879.1115384615384,48.74263692081763,322,2254,2589,2382.776923076923,87.0467202813036,335,1914,2184,2055.023076923077,47.55244459157686,270,4
1737,2048,1878.3307692307692,44.4463823373838,311,2227,2599,2384.5153846153844,93.9132298619036,372,1928,2176,2053.4653846153847,45.03146426647455,248,4
1737,2030,1879.173076923077,48.79953523492451,293,2227,2603,2381.0307692307692,96.31980503045487,376,1908,2167,2046.9153846153847,47.60285099268133,259,4
1741,2030,1884.25,49.61725125016118,289,2236,2603,2382.0,95.98447429151918,367,1908,2167,2046.4653846153847,48.1105021670988,259,4
1755,2041,1881.7153846153847,47.2611629460969,286,2238,2595,2382.2384615384617,92.6374011416992,357,1909,2170,2047.1807692307693,46.43160386249691,261,4
1757,2041,1876.6384615384616,45.439000452285065,284,2259,2597,2381.9653846153847,85.81061774403048,338,1903,2170,2046.8576923076923,45.98353468183434,267,4
1772,1998,1870.4538461538461,40.80665619458656,226,2276,2597,2383.3423076923077,78.1165977008269,321,1903,2154,2040.496153846154,41.0134640362678,251,4
1766,1996,1871.996153846154,41.20056397231076,230,2240,2646,2381.6653846153845,77.80209246874786,406,1905,2228,2033.8884615384616,46.201830404856615,323,4
1766,2019,1886.2807692307692,41.441706923883736,253,2240,2646,2378.373076923077,70.19473221439362,406,1905,2229,2047.3576923076923,49.85530161277835,324,4
1717,2019,1884.9653846153847,43.724421688285965,302,2231,2607,2379.4384615384615,68.03967770939059,376,1934,2231,2066.5923076923077,46.58229669424174,297,4
1717,1998,1868.9423076923076,41.31123673249544,281,2231,2607,2377.826923076923,79.64155246180776,376,1901,2231,2046.7653846153846,51.76859293178842,330,4
1758,1969,1865.6038461538462,34.92010716999427,211,2257,2579,2374.596153846154,82.86306786523183,322,1901,2139,2026.8192307692307,40.46689403598345,238,4
1758,1980,1864.85,35.885551130263835,222,2262,2618,2377.2846153846153,82.91403508536546,356,1921,2135,2031.746153846154,40.01733437882952,214,4
1751,1980,1867.5884615384616,39.06251624294286,229,2262,2618,2384.146153846154,79.34910027769511,356,1935,2154,2042.6884615384615,40.91830854835002,219,4
1751,1997,1872.753846153846,39.278052766977,246,2271,2591,2383.45,70.10825468172328,320,1935,2154,2048.6807692307693,35.94904715961178,219,4
1782,1997,1871.6576923076923,40.677018385936606,215,2275,2578,2380.992307692308,67.6719883710979,303,1944,2153,2047.2153846153847,35.02717855185081,209,4
1760,2002,1870.2653846153846,41.93885457445784,242,2275,2601,2382.246153846154,71.24313273561152,326,1944,2153,2047.2769230769231,37.484311340527476,209,4
1760,2004,1871.95,42.28503893074378,244,2274,2601,2382.9423076923076,73.993429078382,327,1930,2146,2045.9153846153847,40.89860040753858,216,4
1760,2004,1867.6692307692308,43.26454288699548,244,2274,2606,2383.1,79.47553471201446,332,1930,2154,2046.323076923077,41.75146456814172,224,4
1751,2000,1867.8346153846153,45.030058106293104,249,2229,2606,2384.6615384615384,86.97787885865814,377,1930,2156,2049.9615384615386,43.85821378650659,226,4
1751,2000,1873.8192307692307,45.38554290958196,249,2229,2615,2380.242307692308,86.55709242736987,386,1930,2158,2056.5884615384616,43.28539417604221,228,4
1753,1987,1875.95,45.627006752292495,234,2267,2615,2374.726923076923,80.19824884565197,348,1941,2158,2059.476923076923,39.39860950148407,217,4
1753,2020,1877.4,46.11804561420759,267,2227,2588,2379.0,84.92972338974097,361,1950,2182,2055.5730769230768,41.85761909390304,232,4
1739,2022,1881.6538461538462,46.45198651066551,283,2227,2588,2379.9076923076923,88.65249899278405,361,1944,2182,2052.0730769230768,44.07038997273875,238,4
1739,2024,1883.55,46.01293883833699,285,2223,2596,2379.9307692307693,91.96345492573145,373,1928,2192,2053.5923076923077,49.25698055758324,264,4
1746,2041,1882.073076923077,45.57634401038693,295,2223,2598,2381.3884615384613,96.29567091518828,375,1928,2192,2054.7076923076925,48.46906367622686,264,4
1773,2041,1887.8807692307691,43.86990700604163,268,2257,2598,2382.892307692308,95.55040685146375,341,1942,2172,2052.857692307692,44.25713452138487,230,4
1776,2029,1897.9653846153847,42.45836882009344,253,2259,2605,2380.0653846153846,96.23310438804508,346,1942,2160,2051.0730769230768,43.726051869767666,218,4
1783,2029,1899.45,42.10248344182457,246,2252,2605,2378.496153846154,95.20027651872998,353,1948,2160,2051.1807692307693,42.470180492508284,212,4
1790,2025,1898.673076923077,41.47898996186633,235,2252,2592,2386.8423076923077,89.89763665266777,340,1948,2157,2053.7384615384617,42.15856331689282,209,4
1792,2087,1912.4076923076923,47.508535490593104,295,2252,2583,2387.0846153846155,86.63686559742614,331,1937,2163,2057.1961538461537,40.27890200266073,226,4
1795,2087,1910.2692307692307,48.18341541071493,292,2252,2635,2387.2384615384617,89.28655909312238,383,1937,2179,2054.276923076923,40.563314423040886,242,4
1786,2036,1897.0884615384616,43.38171088515112,250,2240,2635,2385.1846153846154,91.52861312773739,395,1927,2205,2055.0730769230768,47.02868637169596,278,4
1786,2078,1915.85,51.57837496934897,292,2240,2640,2382.55,90.15983982986393,400,1904,2205,2040.4692307692308,50.833392554833466,301,4
1799,2099,1938.6153846153845,50.19604571719774,300,2240,2640,2388.6884615384615,89.36411494607351,400,1904,2130,2014.626923076923,40.9805873403315,226,4
1808,2099,1926.9846153846154,49.26596084047176,291,2243,2637,2384.7884615384614,91.07965382703945,394,1921,2171,2025.7269230769232,45.77760624736984,250,4
1791,2034,1899.4,48.234081736119336,243,2243,2637,2379.8076923076924,92.39541483164996,394,1935,2171,2055.153846153846,46.03623913109447,236,4
1764,2030,1885.8384615384616,45.31891349540411,266,2229,2651,2380.746153846154,97.2966495622435,422,1960,2218,2069.2076923076925,49.132897730966775,258,4
1764,2052,1886.5192307692307,46.90691117530887,288,2229,2678,2380.8384615384616,104.2137915302689,449,1960,2218,2077.2653846153844,51.33968519491794,258,4
1767,2052,1888.7230769230769,46.81162700578162,285,2223,2678,2377.076923076923,104.75838097411769,455,1982,2235,2081.392307692308,50.210675256482155,253,4
1733,2017,1879.253846153846,48.142053560866316,284,2223,2625,2367.976923076923,96.83440989804677,402,1943,2235,2087.1115384615387,52.63664934973402,292,4
1733,2017,1872.5923076923077,46.95232053818431,284,2229,2592,2369.653846153846,90.44255938913133,363,1943,2216,2090.0384615384614,49.145109199611696,273,4
1748,2050,1875.2423076923078,48.00264369390296,302,2246,2592,2376.6115384615387,91.45642178888853,346,1975,2197,2081.5423076923075,45.87647232297524,222,4
1748,2050,1877.8346153846153,48.51986372123458,302,2246,2583,2371.5923076923077,91.56656301202672,337,1951,2197,2072.973076923077,45.678193285717214,246,4
1737,2040,1877.5884615384616,47.997303873146656,303,2248,2596,2374.1769230769232,91.10284954450763,348,1951,2195,2073.4692307692308,46.571684847360096,244,4
1737,2034,1879.3461538461538,48.10593386663306,297,2240,2600,2382.4653846153847,93.43873942293969,360,1969,2195,2070.5576923076924,48.385283453604515,226,4
1760,2027,1884.326923076923,44.87275925675313,267,2235,2600,2382.0807692307694,91.23653555596805,365,1930,2185,2056.6615384615384,47.42285812271833,255,4
1747,2049,1881.7576923076922,46.56998447619941,302,2234,2588,2385.9615384615386,94.14626785231451,354,1930,2168,2051.6653846153845,46.08502669175407,238,4
1743,2049,1876.8692307692309,48.06067408212658,306,2234,2597,2383.2846153846153,98.97281203955723,363,1958,2172,2051.826923076923,46.20657040721751,214,4
1743,2037,1876.1346153846155,48.649494494016224,294,2236,2634,2378.8653846153848,96.14552773640854,398,1953,2183,2055.673076923077,47.29024859437315,230,4
1747,2037,1876.923076923077,47.13852343933136,290,2230,2634,2380.8230769230768,94.48367842418864,404,1953,2183,2068.5384615384614,45.82772067406345,230,4
1771,2009,1880.5461538461539,40.87972971721195,238,2230,2596,2375.9,93.27390229544837,366,1975,2178,2065.846153846154,43.94151281938924,203,4
1756,2049,1887.0961538461538,42.551562913546505,293,2241,2596,2378.9269230769232,94.74084977441682,355,1947,2194,2056.5153846153844,46.000962658281026,247,4
1756,2049,1888.2038461538461,47.11401582417367,293,2229,2605,2383.903846153846,100.18243197422228,376,1943,2194,2055.3192307692307,47.611949112042225,251,4
1704,2036,1885.5461538461539,48.8207835257578,332,2229,2622,2380.869230769231,103.04101132486042,393,1934,2206,2059.1769230769232,49.036975314806554,272,4
1704,2036,1885.1692307692308,47.43622232635298,332,2229,2627,2375.019230769231,99.75593582838434,398,1934,2206,2060.1346153846152,49.42082660344829,272,4
1734,2099,1882.996153846154,52.28179497240014,365,2201,2632,2377.496153846154,100.63123159732655,431,1950,2202,2057.223076923077,49.52987716327118,252,4
1723,2099,1889.1692307692308,58.32635363507244,376,2197,2632,2383.5423076923075,106.2903166228298,435,1927,2218,2058.6153846153848,52.89260403522936,291,4
1723,2044,1895.8461538461538,52.541869538950124,321,2197,2625,2383.253846153846,107.28278307816005,428,1923,2218,2055.9461538461537,52.755692702902806,295,4
1761,2027,1893.4384615384615,47.50541588245006,266,2206,2606,2389.0153846153844,107.97493521640398,400,1923,2179,2051.246153846154,49.30905788780789,256,4
1759,2029,1892.5423076923078,47.87082581036141,270,2222,2628,2390.873076923077,110.93434023681687,406,1918,2165,2048.130769230769,49.635176911649936,247,4
1754,2029,1888.0307692307692,50.9676161037368,275,2193,2628,2384.6,109.5761296329095,435,1918,2178,2051.1692307692306,48.44367640043212,260,4
1754,2031,1888.4692307692308,48.80821952132953,277,2193,2620,2380.776923076923,107.48944567994074,427,1940,2191,2057.776923076923,48.48775117142487,251,4
1767,2031,1893.4384615384615,46.47231148840926,264,2213,2622,2388.742307692308,111.32833859960803,409,1927,2191,2059.246153846154,50.63619373949939,264,4
1759,2030,1889.6615384615384,45.82947304890816,271,2226,2622,2388.3038461538463,111.52593749520663,396,1927,2182,2054.0730769230768,49.295328259170645,255,4
1759,2030,1889.3,46.7316581820919,271,2223,2620,2380.7961538461536,108.35812559671464,397,1935,2182,2053.55,48.15605063079003,247,4
1750,2029,1889.7923076923078,46.592241910397554,279,2223,2627,2382.3115384615385,107.67342597742798,404,1934,2182,2053.523076923077,50.210016903460584,248,4
1749,2049,1888.503846153846,53.10290862155202,300,2217,2634,2386.0923076923077,107.80437352994058,417,1934,2199,2052.8076923076924,51.981894108596265,265,4
1745,2049,1890.8692307692309,51.58303101029531,304,2189,2634,2383.4461538461537,110.70239498502396,445,1937,2199,2055.8,52.263868677241724,262,4
1745,2013,1891.9615384615386,43.19970753621755,268,2189,2628,2380.269230769231,109.81727810701999,439,1931,2186,2053.576923076923,52.433648512071876,255,4
1768,2013,1896.4692307692308,44.15944932465717,245,2209,2655,2390.2153846153847,103.81829869844306,446,1899,2186,2045.753846153846,53.40514074982912,287,4
1773,2022,1898.0576923076924,46.0033629211974,249,2230,2655,2391.5730769230768,102.64286797293003,425,1879,2170,2037.6115384615384,55.23287887500442,291,4
1761,2028,1895.0692307692307,43.37404673197937,267,2230,2614,2384.326923076923,103.71573884760443,384,1879,2161,2035.2076923076922,51.39042714724215,282,4
1761,2032,1894.9576923076922,44.64370033061753,271,2206,2613,2384.4,104.34085071252356,407,1908,2175,2038.1846153846154,51.25916957094082,267,4
1766,2032,1890.7423076923078,48.22156611589298,266,2206,2613,2388.226923076923,109.4168045146042,407,1908,2175,2043.626923076923,52.381685455805744,267,4
1756,2041,1889.9692307692308,47.22948795217382,285,2215,2621,2386.653846153846,110.99335341597939,406,1903,2173,2043.7,50.050422452211,270,4
1754,2041,1893.1423076923077,48.80707171589225,287,2215,2621,2380.5115384615383,107.15850788572885,406,1903,2159,2046.7846153846153,47.42781299825499,256,4
1754,2050,1894.9423076923076,48.186339347094005,296,2216,2621,2380.7615384615383,103.4491876349661,405,1898,2152,2049.2192307692308,48.19124160826081,254,4
1774,2053,1897.926923076923,49.47655002199529,279,2241,2626,2383.7653846153844,105.11443825276872,385,1898,2160,2044.3961538461538,51.033269342112305,262,4
1774,2053,1890.2153846153847,47.70970528745675,279,2217,2626,2383.242307692308,108.01343643386433,409,1909,2182,2042.8692307692309,49.19135882642177,273,4
1755,2007,1884.3153846153846,45.738054687203814,252,2217,2619,2377.2076923076925,105.1639423322213,402,1922,2182,2045.253846153846,48.85473092940676,260,4
1751,2022,1888.8423076923077,49.46683045352022,271,2215,2627,2379.423076923077,106.9907342998319,412,1922,2163,2041.6538461538462,50.48279825359247,241,4
1751,2022,1897.3192307692307,49.56492189070293,271,2212,2627,2379.3423076923077,115.14876284783777,415,1923,2171,2036.4346153846154,49.48093070782424,248,4
1770,2031,1896.5692307692307,47.546431435630815,261,2212,2615,2378.642307692308,115.58472689408013,403,1910,2171,2038.4769230769232,47.80182956137672,261,4
1752,2031,1885.5807692307692,44.5647896681952,279,2210,2615,2380.6961538461537,107.48114670186068,405,1885,2161,2036.05,49.672454164282065,276,4
1743,2001,1877.6884615384615,45.83636184430509,258,2210,2635,2378.857692307692,103.0600105313199,425,1882,2176,2037.4769230769232,49.98165151898733,294,4
1743,2001,1878.8961538461538,48.063029569564286,258,2229,2635,2378.4653846153847,91.06238449825412,406,1882,2176,2049.003846153846,48.86854939820825,294,4
1744,2110,1887.9307692307693,55.09159637988349,366,2179,2627,2385.869230769231,106.7979283750275,448,1943,2195,2057.0423076923075,54.45122980325079,252,4
1744,2110,1889.946153846154,56.013830550581105,366,2179,2632,2386.892307692308,121.56440028027701,453,1920,2195,2055.892307692308,58.35376682581941,275,4
1747,2039,1885.7153846153847,46.27327499341254,292,2217,2632,2380.0384615384614,108.29392321166411,415,1920,2174,2047.0653846153846,52.46921835103773,254,4
1745,2022,1875.9846153846154,47.7623597160254,277,2217,2624,2384.7076923076925,99.4040501768675,407,1900,2153,2046.5230769230768,46.877926638664455,253,4
1745,2018,1872.6307692307691,47.78202412541592,273,2246,2619,2382.7807692307692,95.65326103639305,373,1900,2168,2050.7846153846153,46.478622082225186,268,4
1770,2018,1878.2115384615386,45.73987916344496,248,2241,2633,2379.369230769231,100.97460504637225,392,1913,2186,2054.7923076923075,49.912076540807085,273,4
1775,2013,1884.1461538461538,45.97911420067749,238,2237,2633,2382.4692307692308,104.33649072449818,396,1947,2197,2057.230769230769,52.169021186972365,250,4
1775,2013,1887.3,43.189382722178145,238,2226,2627,2380.1576923076923,102.08937969441996,401,1917,2197,2054.6923076923076,49.93576509457561,280,4
1761,2024,1888.876923076923,46.339025204521256,263,2226,2627,2379.5846153846155,102.56116243682129,401,1917,2175,2056.3423076923077,48.00508879940283,258,4
1761,2024,1889.5115384615385,50.56900043083514,263,2230,2610,2383.4846153846156,107.53896552426524,380,1947,2191,2064.75,49.84380041845164,244,4
1744,2020,1882.8384615384616,45.36923657025349,276,2233,2609,2381.8,100.74976838740538,376,1979,2191,2067.4461538461537,45.60736605452938,212,4
1726,1950,1867.7115384615386,37.176889351734395,224,2258,2599,2371.7192307692308,74.93545495072682,341,1999,2165,2070.0884615384616,35.845602272206314,166,4
1726,1982,1874.3076923076924,38.53561681086424,256,2269,2536,2369.5807692307694,57.7733323420757,267,2003,2193,2077.6346153846152,36.98608151345889,190,4
1797,1983,1884.0076923076922,36.32053699742623,186,2269,2536,2374.6615384615384,56.14508973962996,267,2003,2193,2073.923076923077,37.839656708797186,190,4
1791,1993,1872.9115384615384,37.0365031968809,202,2267,2572,2373.4192307692306,64.98177064977929,305,1995,2212,2074.6153846153848,38.27988465695227,217,4
1779,1993,1870.4192307692308,35.27735138359342,214,2267,2596,2375.6846153846154,80.94213907619367,329,1974,2212,2066.673076923077,43.42282069708689,238,4
1775,2011,1874.1846153846154,39.37656724644808,236,2277,2599,2375.3423076923077,83.92993342296731,322,1974,2167,2053.1884615384615,38.32666770126849,193,4
1775,2011,1877.3153846153846,41.352993031581555,236,2271,2609,2378.2076923076925,84.22104544936792,338,1962,2148,2050.769230769231,36.479758699486965,186,4
1784,1997,1875.876923076923,38.67686455104461,213,2271,2609,2382.2038461538464,84.5487727045459,338,1962,2143,2047.1807692307693,35.03283092542255,181,4
1763,1993,1873.1038461538462,37.925154708548774,230,2274,2587,2381.9576923076925,68.99008195227346,313,1971,2127,2051.8115384615385,33.196488009378584,156,4
1763,1966,1872.9423076923076,36.942830434642126,203,2269,2529,2374.4307692307693,54.065445606897654,260,1995,2222,2074.626923076923,51.365178007396324,227,4
1762,2001,1880.3692307692309,43.57014288199375,239,2265,2598,2373.4384615384615,58.34480173516652,333,2008,2222,2091.1846153846154,54.381504438071815,214,4
1762,2036,1883.2923076923078,47.16625424024616,274,2238,2617,2377.380769230769,75.02862526692469,379,1967,2217,2073.007692307692,49.59130203873697,250,4
1766,2036,1882.996153846154,44.9496069684393,270,2236,2617,2377.476923076923,88.70968792532602,381,1935,2171,2055.119230769231,45.099602505167894,236,4
1777,2028,1893.673076923077,45.236965593782436,251,2236,2601,2383.576923076923,90.50824876630358,365,1935,2160,2058.8615384615387,44.129285987809524,225,4
1771,2039,1896.0846153846153,45.74438541666941,268,2256,2623,2382.6615384615384,93.31865562668318,367,1968,2174,2060.003846153846,42.511456377945024,206,4
1771,2050,1891.7692307692307,43.64502978448548,279,2257,2630,2379.2961538461536,94.01815720787069,373,1960,2177,2056.876923076923,45.110249395615185,217,4
1775,2050,1886.2807692307692,42.8458899443142,275,2266,2643,2386.642307692308,95.43555375904161,377,1907,2177,2049.496153846154,47.38053443203277,270,4
1775,2019,1885.0192307692307,40.895521077419275,244,2270,2643,2384.6115384615387,85.75996323997168,373,1907,2153,2035.9653846153847,44.94358061031006,246,4
1776,2000,1883.05,36.080794686006364,224,2279,2575,2378.0576923076924,73.9122440788387,296,1926,2127,2029.5192307692307,40.82285414146615,201,4
1776,2003,1882.5423076923078,36.29291679275461,227,2247,2626,2385.3230769230768,79.35796572548168,379,1899,2148,2032.676923076923,40.81178484214801,249,4
1780,2009,1885.3115384615385,37.921467590109216,229,2247,2626,2391.9884615384617,85.68035608278842,379,1899,2148,2033.0115384615385,43.67035896864431,249,4
1775,2014,1885.3923076923077,39.35189155773035,239,2271,2609,2387.8230769230768,89.42941958338479,338,1932,2133,2031.2730769230768,43.5105104924606,201,4
1756,2014,1887.0615384615385,40.095109677089305,258,2271,2626,2383.373076923077,87.22178740997113,355,1932,2133,2032.5346153846153,42.79242745325214,201,4
1756,2017,1888.8807692307691,43.481558858853724,261,2271,2626,2381.6153846153848,81.43660723483633,355,1951,2153,2037.4653846153847,41.704174603847264,202,4
1760,2017,1885.8807692307691,43.633932805445035,257,2269,2637,2378.8230769230768,81.13328234460568,368,1955,2156,2043.8307692307692,41.28788438621428,201,4
1767,2002,1877.1153846153845,38.11466840637536,235,2266,2637,2376.0307692307692,83.34405023653885,371,1947,2161,2050.673076923077,43.38092082533854,214,4
1755,2016,1872.3615384615384,42.99420879492946,261,2266,2638,2378.357692307692,85.18604972654308,372,1947,2240,2055.3115384615385,46.17098344100667,293,4
1755,2016,1868.1538461538462,45.262761214021765,261,2260,2638,2383.269230769231,83.58116656766288,378,1926,2240,2054.142307692308,50.50447186192207,314,4
1771,2007,1871.6538461538462,43.24710565242658,236,2260,2610,2378.5461538461536,75.38791434930157,350,1926,2192,2050.242307692308,46.72930899316102,266,4
1752,2038,1876.3653846153845,44.7041017380588,286,2267,2607,2378.4653846153847,76.07775661765436,340,1927,2160,2046.3153846153846,41.65792570427354,233,4
1744,2038,1883.9884615384615,48.90306246912885,294,2267,2589,2385.476923076923,81.22994820079899,322,1927,2166,2042.3153846153846,43.394043435049994,239,4
1744,2017,1884.0692307692307,47.67306427450471,273,2274,2589,2379.0538461538463,78.74378681511298,315,1948,2182,2049.126923076923,46.46561445201523,234,4
1774,2021,1880.3423076923077,44.627351699944285,247,2260,2615,2375.023076923077,81.2264545399891,355,1969,2189,2059.746153846154,47.35348246699815,220,4
1743,2025,1883.6538461538462,50.019102380096776,282,2260,2615,2377.992307692308,87.18333730440871,355,1933,2243,2057.2115384615386,51.040500437228125,310,4
1743,2025,1879.9884615384615,47.70570032169995,282,2227,2672,2376.7846153846153,90.6119039470926,445,1933,2243,2052.2038461538464,52.05818678560377,310,4
1768,2050,1877.176923076923,44.56741288940039,282,2227,2672,2379.6653846153845,88.82288759579572,445,1965,2198,2051.623076923077,47.36986080308567,233,4
1770,2050,1878.3576923076923,46.25269415571072,280,2239,2624,2377.0807692307694,84.22623752851061,385,1945,2190,2052.7076923076925,48.010044983986624,245,4
1757,2019,1879.8076923076924,41.91526590503174,262,2259,2600,2374.5807692307694,85.44960139043586,341,1937,2190,2048.3615384615387,47.849910752413734,253,4
1757,2019,1875.0384615384614,41.16581102837642,262,2270,2630,2378.630769230769,84.1562839643014,360,1929,2153,2042.1884615384615,44.560997428608935,224,4
1771,2004,1878.0653846153846,41.038539587949906,233,2270,2630,2375.2961538461536,78.2749385711417,360,1929,2153,2040.0384615384614,42.83602637879891,224,4
1762,1990,1875.246153846154,38.79021122758275,228,2257,2617,2375.2076923076925,73.86120722597168,360,1943,2133,2027.3846153846155,40.5574828473047,190,4
1758,1978,1861.4076923076923,33.860535257669035,220,2257,2573,2379.5923076923077,77.08078259103915,316,1936,2119,2011.6038461538462,35.19894896607011,183,4
1733,1999,1867.0346153846153,39.111299874125606,266,2241,2610,2377.607692307692,88.14926759136105,369,1936,2162,2017.7807692307692,40.2965121959568,226,4
1733,2030,1876.35,41.73630910932947,297,2241,2610,2383.2884615384614,93.27659216691318,369,1910,2162,2033.0192307692307,44.1633902022369,252,4
1756,2032,1885.303846153846,43.76971133029814,276,2247,2639,2383.423076923077,89.87437524902927,392,1908,2152,2038.3923076923077,45.4955547328033,244,4
1775,2032,1886.6076923076923,44.426590554778656,257,2261,2672,2381.0807692307694,90.92899567372476,411,1908,2145,2037.5230769230768,46.517853156725344,237,4
1775,2017,1880.9576923076922,43.8116596765236,242,2261,2672,2384.123076923077,90.93478637317719,411,1934,2145,2038.503846153846,44.075093701135614,211,4
1776,2007,1882.1307692307691,46.14010700366303,231,2264,2599,2387.4461538461537,90.03457607288928,335,1939,2159,2044.7076923076922,46.310675929840464,220,4
1776,2019,1881.5923076923077,45.9523332271271,243,2261,2601,2385.0,88.50508787154882,340,1926,2159,2046.003846153846,48.813370697946674,233,4
1784,2036,1894.9923076923078,45.60489985085913,252,2261,2601,2377.8076923076924,83.7105323269015,340,1926,2182,2062.596153846154,50.034142634459414,256,4
1769,2057,1912.2423076923078,45.54897803529076,288,2247,2627,2378.4076923076923,87.94160015103795,380,1991,2214,2099.2384615384617,47.748586078830364,223,4
1755,2057,1901.926923076923,49.13740923812515,302,2235,2627,2377.0307692307692,95.083457627833,392,2007,2214,2095.5538461538463,46.61790160044475,207,4
1755,2035,1891.2230769230769,45.068162085215256,280,2235,2609,2377.9576923076925,88.0218587851769,374,1920,2176,2061.7384615384617,42.511420922158194,256,4
1770,2029,1892.696153846154,43.33513987613688,259,2255,2603,2380.9384615384615,83.67585498845355,348,1920,2173,2047.326923076923,44.85640803550081,253,4
1770,2029,1887.0884615384616,43.017863102280494,259,2246,2603,2382.492307692308,89.30531952263591,357,1922,2173,2044.076923076923,45.77393086957627,251,4
1787,2028,1880.7769230769231,39.57403801363319,241,2241,2591,2383.903846153846,88.58559537056635,350,1912,2152,2036.7807692307692,43.030047140747556,240,4
1787,2008,1880.6384615384616,37.0715688594537,221,2241,2589,2380.9192307692306,78.94476109549832,348,1912,2116,2027.573076923077,37.866541273595985,204,4
1788,2037,1886.5576923076924,40.70005808650312,249,2249,2608,2382.6346153846152,79.2104447029844,359,1969,2154,2030.7346153846154,36.555278311597796,185,4
1769,2037,1887.173076923077,43.941397071513066,268,2249,2608,2383.3153846153846,86.33771659478438,359,1879,2154,2034.003846153846,44.524298001912534,275,4
1740,2015,1881.6653846153847,44.25714123217348,275,2255,2618,2381.9192307692306,86.99969608623422,363,1879,2179,2032.8961538461538,47.58873833206777,300,4
1740,2062,1878.3076923076924,45.76384676062176,322,2215,2659,2384.1692307692306,92.37978839781624,444,1924,2179,2037.5307692307692,45.829916964590815,255,4
1771,2062,1875.0384615384614,44.26480579843351,291,2215,2659,2384.4884615384617,90.13908098268986,444,1924,2154,2042.5576923076924,44.45187995709104,230,4
1750,2021,1876.8576923076923,44.281642248383704,271,2254,2620,2379.642307692308,85.98261776871276,366,1931,2165,2044.1807692307693,44.3377047351581,234,4
1735,2045,1885.3846153846155,47.13201448513303,310,2253,2627,2371.9615384615386,87.81868859828224,374,1935,2189,2050.9346153846154,50.29994544166535,254,4
1735,2045,1884.923076923077,44.664535158453184,310,2253,2627,2373.480769230769,88.70433522781786,374,1903,2189,2049.896153846154,51.214598702763645,286,4
1755,2013,1879.2653846153846,47.62898311606109,258,2261,2619,2381.9576923076925,90.46368188299512,358,1903,2166,2038.8346153846153,48.60032764644542,263,4
1755,2013,1881.8692307692309,47.15969558252988,258,2241,2625,2384.4076923076923,94.45884856313923,384,1908,2166,2034.1423076923077,47.0308259469105,258,4
1757,2011,1880.9857142857143,41.845749850944635,254,2241,2625,2383.5142857142855,93.81572228094292,384,1926,2163,2033.4095238095238,45.502656789376324,237,4
1882,1908,1894.4346153846154,4.39281989693029,26,2372,2394,2384.857692307692,3.2795932835844304,22,1991,2021,2006.303846153846,4.855040032936261,30,3
1885,1905,1893.1884615384615,3.274898910647911,20,2377,2393,2384.8115384615385,2.879675405758511,16,1991,2015,2003.7076923076922,3.926833052221322,24,3
1884,1900,1892.3076923076924,3.376837189298501,16,2377,2393,2384.5846153846155,2.8872897215973907,16,1987,2015,2000.0653846153846,5.177128369343197,28,3
1867,1903,1888.9653846153847,6.510071929789757,36,2375,2393,2383.5884615384616,3.429919111924524,18,1985,2021,1996.55,5.622057359857596,36,3
1867,1903,1884.2961538461539,5.977498396527353,36,2374,2393,2382.35,3.41422755641006,19,1985,2021,1996.246153846154,5.69909772505393,36,3
1871,1890,1881.6884615384615,2.9850110653548776,19,2373,2389,2381.730769230769,2.753133592789238,16,1981,2009,1994.1384615384616,4.488086066790224,28,3
1871,1886,1879.9730769230769,2.8507341995853417,15,2373,2389,2381.3384615384616,2.6655353505588155,16,1980,2005,1991.1615384615384,4.03518089838422,25,3
1869,1885,1877.7653846153846,3.288383944047435,16,2374,2389,2380.492307692308,2.7488043138654223,15,1980,2000,1990.6461538461538,3.7310375930351496,20,3
1864,1903,1880.6307692307691,6.951168298835867,39,2371,2392,2380.7615384615383,3.8046990782104007,21,1972,2000,1988.5884615384616,5.302787707381606,28,3
1864,1903,1882.4076923076923,5.900325432875735,39,2371,2392,2381.369230769231,3.67741402664616,21,1972,2000,1985.9846153846154,4.527879514926705,28,3
1867,1887,1878.753846153846,3.3887425224669823,20,2373,2388,2380.7807692307692,2.952980201439229,15,1976,1997,1985.9115384615384,3.602318743073734,21,3
1867,1887,1876.7115384615386,3.349272602764213,20,2372,2388,2380.226923076923,2.906265059552655,16,1977,2004,1986.8461538461538,4.0211055904179105,27,3
1864,1884,1874.826923076923,3.539742120518708,20,2371,2392,2379.9115384615384,3.0383427360201782,21,1970,2004,1985.1846153846154,6.27218486177687,34,3
1864,1883,1873.3846153846155,3.3262373733477086,19,2371,2392,2379.476923076923,3.1135905470125795,21,1969,2002,1981.3,5.348329945378574,33,3
1864,1881,1872.7615384615385,2.9794763763586842,17,2372,2386,2379.096153846154,2.759746612680477,14,1968,1994,1980.4153846153847,3.5112276953680928,26,3
1864,1879,1872.2423076923078,2.907674982623368,15,2371,2387,2378.619230769231,2.737769465346132,16,1968,1994,1979.173076923077,3.837033290554628,26,3
1864,1894,1873.1153846153845,4.386949081687892,30,2371,2391,2378.4269230769232,3.0438313709713642,20,1969,1989,1977.8,3.5617010382279823,20,3
1864,1895,1877.9807692307693,6.099213141906172,31,2370,2391,2379.6923076923076,3.99390685310661,21,1969,2005,1981.6,5.9041245971513225,36,3
1870,1965,1890.0,19.81302562850976,95,2354,2425,2382.1923076923076,8.149279195778691,71,1962,2070,1991.7846153846153,24.211419053678217,108,3
1806,1991,1906.446153846154,37.394497466183985,185,2350,2468,2384.596153846154,16.977909353021236,118,1959,2070,2007.0115384615385,30.94127988162094,111,3
1806,1991,1908.2384615384615,34.22507916654166,185,2327,2468,2385.5923076923077,19.909523595232752,141,1904,2070,2002.5615384615385,26.289009652553073,166,3
1869,1943,1898.123076923077,11.985522402162838,74,2327,2452,2384.373076923077,13.413934370036083,125,1904,2041,1987.1461538461538,13.628049395409834,137,3
1882,1912,1894.7423076923078,6.222928898424284,30,2362,2407,2383.357692307692,4.40328703799068,45,1966,2000,1984.4769230769232,4.979053242431858,34,3
1881,1911,1892.4692307692308,5.918609433806021,30,2375,2394,2383.6961538461537,3.2137471086210994,19,1972,1997,1985.6576923076923,4.1527469698149675,25,3
1881,1919,1891.7230769230769,6.385934573745677,38,2375,2410,2383.9115384615384,3.8288507427292084,35,1967,2010,1988.446153846154,4.753477147893423,43,3
1883,1951,1905.5346153846153,15.435341343804561,68,2363,2417,2386.2884615384614,7.285508275242766,54,1967,2046,2002.3,14.98964893816981,79,3
1894,1951,1911.3884615384616,10.783185356242674,57,2363,2417,2387.5807692307694,6.515589812358557,54,1994,2046,2011.45,8.304148379507698,52,3
1895,1926,1904.1797235023041,4.96934621203302,31,2378,2395,2386.4608294930877,2.8020470779903532,17,1999,2022,2007.9769585253457,4.038520993843703,23,3
1793,2079,1932.7,51.389368369996355,286,2171,2623,2371.8115384615385,108.56447945067575,452,1982,2316,2142.492307692308,70.18846621789645,334,5
1783,2079,1938.1538461538462,47.49305359302705,296,2196,2623,2366.346153846154,110.70652089616839,427,1986,2361,2142.15,75.51049301908017,375,5
1783,2055,1915.3384615384616,47.096721942203345,272,2196,2657,2371.153846153846,106.41243152755031,461,1993,2361,2120.35,74.96086881354734,368,5
1799,2070,1919.2269230769232,44.78777116685364,271,2217,2657,2377.0923076923077,105.0866490169127,440,2003,2277,2116.5423076923075,60.91099065274494,274,5
1823,2130,1933.7423076923078,44.27867762198067,307,2217,2644,2364.75,98.12116750993903,427,2034,2377,2144.003846153846,65.25243515785671,343,5
1656,2130,1921.1653846153847,58.721970672141445,474,2195,2646,2360.1615384615384,90.73699137508144,451,1990,2377,2137.4153846153845,69.30529902413286,387,5
1656,2108,1912.8692307692309,55.956738455315445,452,2175,2677,2380.8884615384613,109.8740199157665,502,1977,2269,2119.526923076923,63.73923746045596,292,5
1743,2143,1921.0807692307692,49.03837059805098,400,2175,2677,2380.976923076923,103.59924012367347,502,1977,2304,2124.392307692308,64.04721908597026,327,5
1743,2143,1927.8576923076923,55.692125789584246,400,2232,2622,2371.523076923077,84.09726997204378,390,1986,2308,2124.4615384615386,70.0223520679632,322,5
1798,2105,1928.4038461538462,53.681190890480956,307,2232,2630,2373.5730769230768,88.2907099608983,398,1986,2308,2121.35,64.61233221996768,322,5
1827,2083,1929.6692307692308,47.41713169081802,256,2242,2630,2365.5115384615383,90.35021875187701,388,2005,2282,2132.096153846154,56.82583960599304,277,5
1795,2083,1918.9,47.35764688143529,288,2229,2627,2366.476923076923,92.65348033974449,398,1973,2282,2131.019230769231,62.17905716545684,309,5
1795,2055,1914.0846153846153,48.73583898715607,260,2215,2654,2370.5,95.44767512757284,439,1973,2262,2118.5307692307692,61.26519207530293,289,5
1799,2055,1924.6461538461538,50.355548445839204,256,2215,2654,2370.9461538461537,93.31884244784841,439,2014,2262,2118.876923076923,57.38019452813595,248,5
1768,2049,1911.9307692307693,49.221850385682934,281,2270,2636,2376.730769230769,85.68648866171573,366,1987,2235,2108.380769230769,51.807234920806096,248,5
1768,2048,1909.3423076923077,48.83952663007046,280,2270,2620,2379.3230769230768,85.56062813596618,350,1987,2239,2108.5423076923075,50.55157290937171,252,5
1791,2071,1923.4307692307693,48.69873321932119,280,2241,2619,2377.376923076923,87.97948737626402,378,2016,2239,2110.9461538461537,53.304227963086745,223,5
1719,2071,1903.1307692307691,54.86957346353343,352,2241,2604,2371.9,77.95874069637895,363,1981,2227,2091.6346153846152,52.51990938768728,246,5
1719,2024,1902.45,55.70732780035649,305,2268,2604,2368.723076923077,74.46613237442153,336,1981,2206,2087.1807692307693,50.071165719120586,225,5
1790,2082,1927.18407960199,50.60238082613932,292,2281,2643,2373.4328358208954,84.41200575995046,362,1987,2222,2100.8457711442784,51.664601948794335,235,5
1851,1962,1897.2615384615385,19.737487154356785,111,2332,2444,2384.473076923077,15.120725445108048,112,1974,2061,2005.7115384615386,16.163183937532697,87,3
1869,1962,1903.2153846153847,15.730100312332906,93,2364,2418,2386.1846153846154,8.990157308019056,54,1978,2061,2010.2730769230768,13.72279499464677,83,3
1862,1968,1902.9923076923078,19.987446312573553,106,2343,2439,2385.4,9.910487405660763,96,1961,2039,2009.7384615384615,12.932288074585829,78,3
1862,1968,1893.8961538461538,22.521049454847095,106,2343,2439,2383.5615384615385,8.832638530784752,96,1961,2039,1997.8846153846155,17.245730092263607,78,3
1871,1901,1883.4653846153847,5.130230060071426,30,2369,2400,2381.619230769231,4.062876401881389,31,1967,2008,1983.5384615384614,7.07778497095243,41,3
1871,1902,1884.5230769230768,5.2961928259513416,31,2371,2393,2381.8115384615385,3.661215584269732,22,1967,2020,1988.9538461538461,12.351581605671727,53,3
1871,1903,1888.5653846153846,6.5624085833790025,32,2373,2393,2383.1576923076923,3.8195466666787485,20,1975,2027,2002.9576923076922,11.808075015879412,52,3
1878,1903,1891.3692307692309,4.739774136544786,25,2375,2391,2383.9384615384615,3.41980117770611,16,1967,2027,2004.626923076923,9.453158557445587,60,3
1866,1901,1888.3615384615384,5.083099176476615,35,2368,2399,2382.1615384615384,4.60116461026073,31,1948,2013,1987.1653846153847,16.132641371211275,65,3
1866,1898,1886.9884615384615,4.722804850391943,32,2368,2399,2380.607692307692,4.3371363145226836,31,1948,2007,1973.3923076923077,9.368472680660405,59,3
1879,1897,1886.5846153846153,3.678770600805809,18,2371,2390,2380.392307692308,3.14635574904595,19,1955,1984,1970.076923076923,5.311334691984324,29,3
1878,1897,1885.1923076923076,3.539291105091742,19,2371,2394,2379.980769230769,3.1432368078045965,23,1948,1990,1968.6076923076923,5.283464631754292,42,3
1878,1960,1900.7884615384614,19.114304149160734,82,2359,2411,2383.0884615384616,8.637926022128573,52,1932,2053,1974.4192307692308,19.559759321990256,121,3
1872,1960,1903.3461538461538,17.860122115594898,88,2354,2412,2383.2076923076925,10.660573016860633,58,1932,2053,1977.076923076923,20.34874148617747,121,3
1863,1909,1884.5192307692307,9.152273352239188,46,2354,2412,2379.7884615384614,7.608003656132114,58,1947,2009,1976.4846153846154,10.45027543217195,62,3
1863,1895,1878.2307692307693,5.1036189167027395,32,2365,2395,2378.826923076923,4.060931449946457,30,1961,1998,1976.246153846154,7.03500518061628,37,3
1867,1888,1876.423076923077,3.8702216963135307,21,2370,2386,2378.1153846153848,2.816483788801372,16,1962,1986,1972.3423076923077,5.02754367720415,24,3
1865,1883,1874.3923076923077,3.6771151900880286,18,2370,2386,2377.873076923077,2.9584063450053817,16,1958,1986,1971.4923076923078,5.225045349190656,28,3
1863,1883,1872.7513227513227,3.600614729808167,20,2370,2385,2377.4920634920636,2.831470273698972,15,1957,1984,1970.4550264550264,5.691009952654388,27,3
1796,2029,1879.423076923077,35.69191755724227,233,2251,2635,2383.2961538461536,72.76747215930345,384,1851,2217,2014.5461538461539,52.08740968505007,366,6
1783,2034,1881.1807692307693,39.138034303420625,251,2251,2585,2383.673076923077,77.93738729253334,334,1905,2163,2008.9038461538462,48.848935689209426,258,6
1771,2034,1881.2807692307692,41.27366544015032,263,2277,2585,2380.6576923076923,75.62094392876328,308,1922,2163,2008.2769230769231,47.715698489992604,241,6
1727,2083,1894.3807692307691,56.73093385930516,356,2225,2598,2380.4884615384617,70.67192583955175,373,1921,2274,2048.7884615384614,68.90095194618998,353,6
1727,2133,1915.3961538461538,61.20628441229913,406,2225,2598,2380.826923076923,64.11106469228706,373,1921,2274,2075.7884615384614,67.09917069568526,353,6
1767,2133,1913.2846153846153,58.33311802186351,366,2200,2615,2380.723076923077,82.88537140886076,415,1860,2326,2075.9153846153845,66.51722389833385,466,6
1767,2077,1901.8884615384616,55.392240002100046,310,2190,2615,2386.9884615384617,100.8755677814513,425,1860,2326,2062.3384615384616,69.50454043068798,466,6
1765,2077,1890.1846153846154,51.571262629444405,312,2190,2621,2383.5423076923075,100.57227245584136,431,1874,2190,2044.5307692307692,57.417617796133214,316,6
1751,2069,1891.35,53.44810025482123,318,2200,2621,2378.646153846154,101.3911620693231,421,1911,2187,2049.0307692307692,54.22837998979129,276,6
1747,2069,1887.2153846153847,52.58910212214753,322,2221,2644,2383.2,99.76709557300622,423,1856,2187,2045.2346153846154,54.3163438240757,331,6
1747,2029,1884.1538461538462,49.375319603240904,282,2222,2644,2378.95,89.64193788081016,422,1856,2176,2041.1384615384616,51.767635548555724,320,6
1750,2034,1889.1538461538462,44.83628934571685,284,2261,2602,2380.023076923077,77.295798023181,341,1925,2176,2040.6346153846155,46.23635303038446,251,6
1771,2034,1889.8,43.582327898120646,263,2261,2620,2382.7884615384614,81.47675048877974,359,1909,2164,2042.9423076923076,46.25279432716452,255,6
1761,2031,1883.576923076923,50.32970298023824,270,2202,2635,2381.8230769230768,95.89396214075198,433,1909,2198,2050.5576923076924,50.340007448016436,289,6
1703,2021,1877.246153846154,55.986700232382,318,2167,2648,2383.4153846153845,107.09990894482821,481,1880,2198,2048.1615384615384,55.27178252571509,318,6
1703,2005,1876.3923076923077,49.897887414189874,302,2167,2648,2377.1692307692306,95.12618228117091,481,1880,2190,2041.05,52.817247022270884,310,6
1768,2002,1877.2615384615385,37.13609611536509,234,2276,2590,2378.5692307692307,70.29830959171302,314,1907,2168,2035.9615384615386,43.37844666063591,261,6
1781,2000,1888.2566844919786,36.196274918568136,219,2231,2647,2385.812834224599,64.76394063396785,416,1907,2231,2044.7540106951872,52.985323819709315,324,6
1820,1972,1903.7884615384614,33.15095725218152,152,2319,2478,2382.7,30.34655686422289,159,1982,2161,2058.7807692307692,35.340074480267646,179,7
1803,1972,1896.926923076923,33.32984861995039,169,2321,2478,2381.903846153846,28.112061753596375,157,1982,2162,2043.35,35.5553378036554,180,7
1803,1936,1887.4730769230769,15.107697229972395,133,2324,2461,2381.107692307692,16.634961626705017,137,1986,2162,2018.503846153846,30.373924256264196,176,7
1878,1932,1895.7192307692308,8.970243353179768,54,2367,2421,2383.8192307692307,5.29168643741722,54,1977,2031,1997.923076923077,7.676988011983927,54,7
1865,1940,1905.4730769230769,14.930574411992737,75,2343,2456,2385.923076923077,15.552931360154389,113,1974,2130,2011.65,24.39848957284638,156,7
1854,1957,1911.5884615384616,20.17519458118004,103,2335,2471,2386.7961538461536,19.41779983419724,136,1936,2130,2015.6692307692308,24.094533403793896,194,7
1854,1957,1907.1423076923077,19.097770657195674,103,2335,2471,2385.8423076923077,12.984180249015981,136,1936,2050,1998.873076923077,13.805713597917638,114,7
1778,1932,1888.3961538461538,34.33337560058259,154,2316,2411,2381.2153846153847,14.655890597132922,95,1970,2097,2010.0115384615385,31.709526562912835,127,7
1778,1964,1884.1461538461538,44.56163343437014,186,2316,2504,2379.7153846153847,21.821223282982686,188,1879,2130,2028.123076923077,32.827151250479524,251,7
1778,1964,1893.2384615384615,33.42341071351611,186,2328,2504,2383.269230769231,18.825468849361425,176,1879,2130,2027.7923076923078,22.741351159705804,251,7
1844,1999,1906.6192307692309,28.606726525326216,155,2340,2421,2386.023076923077,12.150259628041248,81,1943,2090,2020.6,21.709596120300436,147,7
1827,1999,1926.3346153846153,29.21957140570945,172,2329,2427,2388.5576923076924,14.036925189843707,98,1943,2156,2018.7346153846154,29.202970207899554,213,7
1827,1999,1924.8,31.689468184593977,172,2311,2449,2386.730769230769,20.264005962048515,138,1936,2156,2034.8115384615385,33.428871378487216,220,7
1624,2029,1910.3692307692309,46.35570686821159,405,2301,2485,2384.246153846154,24.803026823154863,184,1913,2120,2033.1923076923076,35.52031256468057,207,7
1624,2046,1920.1923076923076,48.780114334629786,422,2279,2632,2386.646153846154,40.88997602824119,353,1903,2121,2015.6576923076923,35.51912501397299,218,7
1798,2065,1929.7307692307693,42.924516392314864,267,2279,2632,2386.9384615384615,41.03990973033677,353,1889,2121,2008.8153846153846,44.795681089286326,232,7
1794,2065,1905.2346153846154,46.61402710577067,271,2279,2447,2383.019230769231,23.992188549090542,168,1889,2116,2019.0653846153846,45.43321665397659,227,7
1794,1981,1891.95,28.55681527834816,187,2317,2447,2383.5884615384616,16.2508051935487,130,1924,2116,2027.4153846153847,24.93211930844575,192,7
1803,2040,1909.05,42.64635712533693,237,2315,2573,2384.9,26.680101184736902,258,1856,2175,2013.6153846153845,54.577547056538215,319,7
1803,2040,1928.496153846154,43.370229641158446,237,2309,2573,2383.4076923076923,29.667317835452323,264,1856,2175,2012.65,66.24137300863786,319,7
1794,2051,1924.823076923077,51.66792772092524,257,2309,2484,2381.0692307692307,22.810005412019233,175,1919,2175,2028.7730769230768,57.10944622073347,256,7
1794,2051,1907.2230769230769,51.043892896986236,257,2328,2484,2382.226923076923,20.338602012152453,156,1919,2175,2027.626923076923,42.93367478623779,256,7
1858,1941,1906.8884615384616,19.642339167509757,83,2346,2463,2386.107692307692,9.980479908800941,117,1981,2074,2024.9692307692308,11.328672382005665,93,7
1903,1926,1915.1423076923077,4.667200352755293,23,2377,2395,2387.273076923077,3.3297602372097663,18,2018,2057,2037.1192307692309,7.730824788834107,39,7
1867,1933,1911.303846153846,9.720216593914492,66,2351,2425,2386.607692307692,8.110240586813832,74,1966,2057,2033.8423076923077,17.22512022758526,91,7
1814,2029,1912.7923076923078,38.14688056164614,215,2319,2475,2384.6653846153845,22.668322637611528,156,1965,2164,2038.4769230769232,35.40918350103934,199,7
1814,2029,1912.4653846153847,44.24199373337519,215,2319,2475,2383.2153846153847,25.64819444385663,156,1965,2164,2053.423076923077,34.44762470242103,199,7
1818,1991,1897.5423076923078,41.840501273019505,173,2307,2494,2381.75,23.63221657466054,187,1979,2156,2046.8807692307691,34.23579962904294,177,7
1818,1989,1889.1653846153847,35.58880829577293,171,2307,2494,2381.4384615384615,21.087244345145574,187,1979,2156,2034.803846153846,31.25983991205955,177,7
1846,2021,1910.75,37.587722364980735,175,2327,2457,2382.3846153846152,17.07574975165745,130,1987,2119,2052.4692307692308,30.232991890214876,132,7
1847,2021,1926.4153846153847,39.716424272514224,174,2320,2457,2376.1346153846152,20.581722264118017,137,1987,2313,2084.3423076923077,57.57836810312076,326,7
1832,2007,1908.1576923076923,34.30594433983442,175,2320,2450,2377.626923076923,19.27156181379949,130,1996,2313,2059.903846153846,64.93479343370085,317,7
1832,1946,1896.9,16.231362938987687,114,2333,2441,2385.3307692307694,11.404726014586034,108,1999,2067,2019.446153846154,11.05693342006619,68,7
1880,1915,1894.7807692307692,7.042755210171723,35,2376,2394,2384.326923076923,3.177631483879439,18,1995,2025,2010.073076923077,6.015299521539084,30,7
1880,1900,1890.5846153846153,3.6640476286812955,20,2376,2391,2383.3846153846152,2.898234359012811,15,1993,2023,2005.85,5.036986750154851,30,7
1883,1905,1893.1923076923076,3.5653765175517873,22,2377,2391,2383.9307692307693,2.9334667554324194,14,1993,2022,2005.2153846153847,4.780081929128752,29,7
1874,1986,1906.373076923077,24.368535597682662,112,2349,2455,2385.6923076923076,11.17902486671342,106,1962,2097,2004.076923076923,15.422550497731036,135,7
1861,1986,1908.4615384615386,26.01978868149015,125,2349,2455,2386.492307692308,14.32051537749814,106,1960,2097,2005.2730769230768,19.28345876656421,137,7
1861,1950,1903.3961538461538,18.030668441713534,89,2351,2419,2385.892307692308,10.845525493281698,68,1960,2040,2007.6807692307693,13.860098536891124,80,7
1866,1980,1914.5576923076924,24.312963843805857,114,2357,2416,2385.2884615384614,9.098212600696497,59,1979,2145,2023.176923076923,34.16244757731542,166,7
1845,1980,1913.2346153846154,28.332055358822114,135,2330,2450,2384.619230769231,17.30191854987144,120,1918,2145,2028.3153846153846,40.325228910994255,227,7
1816,1970,1895.6653846153847,29.6408285972022,154,2312,2483,2384.1807692307693,24.041349823512434,171,1918,2129,2016.126923076923,29.746601086683437,211,7
1816,1949,1893.5346153846153,27.041130438144325,133,2312,2483,2384.726923076923,22.632161106812497,171,1928,2083,2016.2653846153846,19.878073178449498,155,7
1850,1938,1892.0961538461538,18.87661585339454,88,2326,2438,2383.5576923076924,14.82642619018196,112,1928,2083,2009.0461538461539,17.14163642817393,155,7
1850,1900,1883.9884615384615,5.439369351012941,50,2343,2413,2381.4461538461537,6.060902666644726,70,1957,2043,1997.1461538461538,8.19700627003004,86,7
1874,1893,1883.7307692307693,3.222240429085543,19,2375,2391,2381.4423076923076,2.7242190020938426,16,1980,2005,1992.696153846154,4.242183888768159,25,7
1870,1893,1882.0115384615385,3.2316995209768176,23,2373,2389,2380.9846153846156,2.6768984974753085,16,1978,2001,1990.0346153846153,4.224715138114995,23,7
1857,1905,1881.946153846154,5.659326587852783,48,2373,2393,2381.0307692307692,3.0603668025001456,20,1978,2008,1990.4884615384615,4.918237035671984,30,7
1857,1905,1882.803846153846,5.917383641900294,48,2374,2393,2381.119230769231,3.341157780371246,19,1974,2010,1990.6884615384615,5.784336920387124,36,7
1867,1898,1881.5461538461539,4.2510258375150665,31,2374,2391,2381.0,3.199903473447635,17,1974,2017,1992.0884615384616,7.275325991346936,43,7
1867,1943,1886.176923076923,15.896365814060964,76,2328,2400,2381.9307692307693,6.390978754823822,72,1981,2043,2004.1115384615384,14.40449380018061,62,7
1839,1943,1890.2346153846154,23.893803696018242,104,2328,2419,2381.976923076923,12.629233345596829,91,1961,2060,2010.323076923077,16.734222851217638,99,7
1839,1968,1891.6038461538462,24.80566912363423,129,2330,2436,2382.5346153846153,14.560576230368772,106,1955,2071,2005.8576923076923,21.7100704899169,116,7
1831,1968,1893.7807692307692,21.462592387520946,137,2333,2439,2383.4307692307693,14.07121350840252,106,1938,2114,2016.673076923077,27.348403603961597,176,7
1831,1951,1890.4692307692308,15.711289235597743,120,2333,2439,2383.373076923077,12.577606431518817,106,1938,2114,2027.4346153846154,18.783041770508262,176,7
1871,1916,1890.9076923076923,7.33579172372282,45,2345,2413,2383.380769230769,9.26930914740101,68,1977,2042,2022.3461538461538,8.899882033369892,65,7
1832,1958,1891.0192307692307,24.108898999933842,126,2297,2505,2381.95,21.192840453475945,208,1973,2114,2031.5,22.060726997895507,141,7
1832,1964,1895.3346153846153,31.560194888433458,132,2297,2505,2383.392307692308,25.072865597067064,208,1969,2127,2035.2038461538461,25.501623549939005,158,7
1847,1964,1908.6115384615384,21.721096748461942,117,2325,2471,2386.9269230769232,14.774444640466676,146,1969,2127,2027.2346153846154,17.73928394361494,158,7
1874,1933,1909.9692307692308,13.917816398617035,59,2368,2395,2386.9884615384617,4.41695810026752,27,1997,2048,2023.2923076923078,11.63004108581976,51,7
1874,1933,1899.7115384615386,12.87441049137573,59,2368,2395,2385.1384615384613,4.359791440858314,27,1997,2042,2014.8,9.176013720523077,45,7
1874,1906,1892.553846153846,6.697041977647389,32,2370,2397,2384.107692307692,4.473424148403951,27,2000,2023,2010.676923076923,4.803819883872155,23,7
1870,1941,1891.2692307692307,11.33163710176069,71,2341,2426,2383.9346153846154,7.68136904161168,85,1905,2125,2009.9769230769232,16.847930058400266,220,7
1844,1960,1896.4192307692308,21.78211726647877,116,2334,2429,2383.05,14.641448279525074,95,1905,2125,1998.5230769230768,28.322662490896057,220,7
1844,1988,1909.4730769230769,34.355894074779336,144,2327,2523,2384.5923076923077,23.996201808155,196,1911,2084,1999.1038461538462,28.80410444756846,173,7
1844,1988,1901.7384615384615,32.81104293015597,144,2327,2523,2384.6346153846152,20.509559731794358,196,1911,2084,2009.6153846153845,18.044939446277994,173,7
1851,1905,1885.4923076923078,8.557095232839169,54,2354,2394,2382.4384615384615,4.415668567513746,40,1984,2027,2009.45,7.187062056491582,43,7
1876,1899,1887.1307692307691,4.332490989082166,23,2376,2390,2382.776923076923,2.6574449499497943,14,1999,2027,2010.0461538461539,3.988132082215621,28,7
1880,1900,1889.053846153846,3.880077892904272,20,2374,2394,2383.2115384615386,3.05885977230456,20,1993,2024,2008.5692307692307,4.405048808407803,31,7
1880,1948,1901.9192307692308,17.48637680948726,68,2360,2420,2385.0615384615385,9.583410574621034,60,1979,2052,2010.753846153846,10.106430949645208,73,7
1813,1956,1903.6653846153847,29.190883464836713,143,2339,2433,2384.757692307692,13.719435614226759,94,1970,2061,2013.926923076923,14.073388938357251,91,7
1813,1956,1890.3,28.800780233961408,143,2314,2433,2382.6615384615384,16.501107413944855,119,1925,2061,2009.9538461538461,16.735905284463275,136,7
1836,1937,1882.696153846154,16.00832266092842,101,2314,2429,2381.4,13.268303450248506,115,1925,2049,1999.8576923076923,13.723375010580368,124,7
1868,1888,1878.2961538461539,3.342828521552149,20,2372,2389,2380.3115384615385,2.8200642018865643,17,1982,2005,1992.553846153846,4.7077715071053055,23,7
1870,1888,1879.4807692307693,3.0535148720700667,18,2372,2389,2380.269230769231,2.8550259457968417,17,1982,2003,1991.676923076923,3.7933397935627635,21,7
1870,1890,1879.696153846154,3.3177864846471294,20,2372,2388,2380.269230769231,2.7050316665792136,16,1983,2004,1992.3961538461538,3.8011358563768542,21,7
1871,1890,1880.2153846153847,3.542319148245249,19,2374,2387,2380.5346153846153,2.5291264394016655,13,1983,2010,1994.0615384615385,4.491525862533197,27,7
1873,1892,1882.2807692307692,3.3140066886837047,19,2374,2387,2381.1653846153845,2.5784138531698124,13,1985,2010,1996.0269230769231,4.676735958107879,25,7
1874,1892,1883.3461538461538,3.139514111538417,18,2374,2389,2381.642307692308,2.591741126563775,15,1986,2014,1996.996153846154,4.9760027040389465,28,7
1874,1941,1899.0615384615385,19.04485818027068,67,2348,2425,2384.8230769230768,8.946400138495676,77,1950,2045,2003.4769230769232,14.541494553692337,95,7
1859,1941,1896.0192307692307,23.617847436900714,82,2348,2425,2383.626923076923,9.790628948459602,77,1950,2045,1999.0423076923078,17.123730357960596,95,7
1859,1925,1876.823076923077,9.993021027720758,66,2369,2392,2379.4884615384617,3.7493708015854352,23,1968,2013,1989.6346153846155,5.47168508682085,45,7
1866,1889,1877.676923076923,3.9830051800531554,23,2372,2389,2380.15,2.9363584202547157,17,1977,2009,1994.2346153846154,5.951116329377671,32,7
1869,1890,1880.25,4.055955152707214,21,2372,2388,2380.6692307692306,2.8240239685794766,16,1982,2009,1995.2230769230769,5.8794391882053825,27,7
1870,1892,1881.8192307692307,3.2326184123434367,22,2374,2387,2380.7923076923075,2.6294916455897543,13,1981,2006,1991.4653846153847,4.950990876815536,25,7
1873,1892,1881.1538461538462,3.1925626372016875,19,2373,2387,2380.5384615384614,2.6498454712833768,14,1979,2002,1988.8461538461538,4.4772467036939165,23,7
1871,1888,1880.4807692307693,3.2826346926958725,17,2371,2387,2380.5846153846155,2.7164154650776418,16,1979,2007,1991.1192307692309,5.437359627142545,28,7
1871,1891,1882.2730769230768,3.5779308198439153,20,2371,2388,2381.653846153846,2.6470980350429048,17,1987,2007,1996.75,4.034001242335706,20,7
1862,1914,1883.673076923077,3.803682192034216,52,2363,2390,2381.973076923077,2.9255970175534958,27,1987,2027,1999.1076923076923,4.496667412653266,40,7
1821,1930,1890.623076923077,19.49725864687379,109,2337,2460,2382.630769230769,12.727702714724932,123,1941,2029,1992.4769230769232,13.357406740094232,88,7
1821,1945,1893.6346153846155,27.637077695698284,124,2323,2460,2383.4307692307693,19.12181574128977,137,1941,2067,1996.8884615384616,20.61559980095062,126,7
1838,1945,1892.3653846153845,22.26657453562046,107,2323,2447,2383.869230769231,15.033495914324101,124,1967,2067,2004.8153846153846,14.84295374624862,100,7
1870,1918,1894.4346153846154,9.468885943436062,48,2367,2403,2384.3153846153846,5.487837890860545,36,1979,2031,2002.4038461538462,6.788758637427305,52,7
1872,1917,1894.4192307692308,6.2389064004802215,45,2371,2401,2384.3884615384613,4.540578681936342,30,1986,2017,2000.9615384615386,5.577677304262421,31,7
1881,1949,1903.8576923076923,16.70175985633796,68,2359,2419,2385.673076923077,7.5037214804279655,60,1986,2044,2003.7730769230768,11.405074319166896,58,7
1879,1949,1904.3115384615385,17.72328762574608,70,2359,2419,2385.5615384615385,8.420882157544797,60,1986,2044,2006.0692307692307,12.322681138797288,58,7
1879,1932,1894.426923076923,7.866553885448827,53,2370,2417,2384.103846153846,4.914008088869563,47,1986,2039,1999.2,8.461495801388262,53,7
1883,1908,1894.75,4.385281630715977,25,2374,2393,2384.257692307692,2.986284358177276,19,1987,2013,1996.7961538461539,5.108172025629271,26,7
1880,1907,1894.1807692307693,5.075683511859571,27,2374,2393,2384.05,3.3301883490509123,19,1988,2015,2001.073076923077,6.321994314898751,27,7
1880,1905,1892.8076923076924,5.129363051136594,25,2373,2393,2383.923076923077,3.462129111737167,20,1987,2015,2001.053846153846,5.635397692950087,28,7
1881,1905,1894.7038461538461,4.2906903593738575,24,2373,2393,2384.5730769230768,3.130132257226194,20,1987,2009,1998.5192307692307,4.013925492781083,22,7
1887,1905,1894.9846153846154,3.081855268800256,18,2373,2393,2384.2115384615386,2.867313720451247,20,1989,2009,1998.753846153846,3.70965876618971,20,7
1888,1938,1904.7769230769231,14.56857854574292,50,2364,2407,2385.4846153846156,6.697818022368646,43,1975,2023,1997.9423076923076,5.900112758357298,48,7
1855,1978,1908.3615384615384,23.563273512563118,123,2364,2420,2385.646153846154,9.769435860983839,56,1975,2028,1998.073076923077,10.129968448433626,53,7
1855,1985,1899.2730769230768,26.637246511096105,130,2363,2420,2383.7884615384614,9.396739224257956,57,1967,2029,1998.0423076923078,10.582737932328389,62,7
1865,1985,1892.6846153846154,18.044575700379102,120,2363,2418,2383.1884615384615,5.999280968697177,55,1967,2029,1996.7307692307693,6.909551848123491,62,7
1877,1901,1887.4769230769232,4.661872599402105,24,2374,2391,2382.4692307692308,2.7863108878099667,17,1984,2006,1995.0192307692307,4.561422865354467,22,7
1875,1897,1885.323076923077,3.7379724948745108,22,2372,2391,2381.6615384615384,3.012339734191792,19,1981,2003,1991.553846153846,4.675676877410827,22,7
1875,1896,1885.15,3.4029001939125,21,2372,2391,2381.376923076923,2.919156234509061,19,1973,2001,1987.176923076923,5.232015173332621,28,7
1878,1896,1885.6884615384615,3.1252894133878093,18,2371,2389,2381.3884615384613,2.806339613365073,18,1973,2002,1987.6884615384615,5.875728948325533,29,7
1878,1896,1885.7730769230768,2.8755469773193445,18,2371,2388,2381.75,2.6904306325227916,17,1978,2002,1990.0461538461539,3.950194831149371,24,7
1875,1896,1886.1538461538462,2.909076565291203,21,2373,2389,2382.0115384615383,2.8126612417892174,16,1979,2000,1990.2076923076922,3.387909809592469,21,7
1873,1895,1884.5923076923077,4.30084153361152,22,2373,2389,2381.880769230769,2.962639857835394,16,1979,2018,1998.7961538461539,9.687430887305323,39,7
1872,1895,1881.5192307692307,4.297302667582331,23,2374,2389,2381.173076923077,2.935083706594475,15,1983,2018,2000.2192307692308,8.5003983204772,35,7
1872,1888,1879.6423076923077,3.060354671565163,16,2374,2389,2380.2615384615383,2.6393337352602013,15,1983,2005,1993.4192307692308,3.9177370379676453,22,7
1863,1886,1877.6307692307691,3.828643239910067,23,2370,2388,2379.7192307692308,2.708847114152567,18,1982,2005,1993.7269230769232,3.8782690972869833,23,7
1860,1894,1874.8076923076924,5.2960189810665375,34,2359,2395,2379.326923076923,3.923600278397271,36,1975,2039,2005.3461538461538,13.830865565569,64,7
1850,1900,1871.9384615384615,6.151565511457894,50,2359,2398,2378.723076923077,4.597322344079512,39,1975,2039,2009.9653846153847,11.080381713860714,64,7
1850,1900,1869.1615384615384,4.439736063242533,50,2366,2398,2377.9192307692306,3.5669568084266,32,1983,2025,1997.9884615384615,7.457204902636441,42,7
1860,1877,1868.2730769230768,2.68386537537436,17,2371,2385,2377.6384615384613,2.6391874441407843,14,1983,2002,1992.123076923077,3.328861469229184,19,7
1863,1876,1868.626923076923,2.7218631042980026,13,2371,2384,2377.5307692307692,2.5413596869607145,13,1983,2006,1993.323076923077,3.8888324112794477,23,7
1863,1879,1870.4,3.324415354876321,16,2372,2387,2378.0307692307692,2.5723161191444217,15,1987,2011,1998.073076923077,4.778334122105421,24,7
1853,1907,1875.5692307692307,8.516564338503416,54,2357,2401,2379.2846153846153,4.755382425595444,44,1971,2036,2000.003846153846,7.270025240896142,65,7
1853,1910,1877.8461538461538,11.178413794315139,57,2357,2403,2379.7,6.040596252755442,46,1971,2036,1997.9807692307693,10.497453974490194,65,7
1855,1910,1873.8307692307692,8.93402542064943,55,2361,2403,2378.8192307692307,4.551084492993956,42,1975,2030,1995.0384615384614,8.704859377070763,55,7
1864,1879,1870.45,2.9944285459169526,15,2370,2385,2378.1653846153845,2.5679104237032773,15,1982,2004,1994.1115384615384,3.907109342660302,22,7
1863,1878,1870.0846153846153,2.838060720736724,15,2370,2385,2378.230769230769,2.6885671329526493,15,1986,2015,1998.8307692307692,5.870728989270316,29,7
1861,1878,1870.5230769230768,3.0101896055301003,17,2371,2387,2378.4,2.759609395447844,16,1991,2015,2000.9692307692308,4.765445866807671,24,7
1861,1882,1871.4884615384615,3.5439683844120156,21,2371,2387,2378.55,2.790185501921895,16,1990,2011,1999.8653846153845,4.058590423060231,21,7
1863,1882,1872.3192307692307,3.516373090967413,19,2372,2386,2378.9307692307693,2.605869411646599,14,1989,2011,2000.176923076923,4.734601759013509,22,7
1863,1885,1872.6307692307691,3.1245409523250234,22,2367,2389,2378.9269230769232,2.944539831674012,22,1986,2011,1997.4423076923076,4.966347995722049,25,7
1867,1885,1873.0384615384614,2.8580411418310914,18,2367,2389,2378.9076923076923,2.97335958822125,22,1986,2007,1997.3423076923077,3.936040096646837,21,7
1865,1881,1873.2269230769232,2.8267964448785734,16,2371,2387,2379.230769230769,2.6524221073092864,16,1987,2007,1997.8692307692309,3.9010709578722884,20,7
1864,1881,1873.7576923076922,2.8903611719277755,17,2371,2387,2379.4269230769232,2.5359283469634115,16,1987,2005,1995.7884615384614,3.52233106859877,18,7
1864,1883,1875.0846153846153,3.061870665957655,19,2372,2387,2379.8,2.6461890715360084,15,1987,2013,1999.7153846153847,5.405894988223562,26,7
1868,1887,1876.55,3.0933669227750724,19,2371,2387,2380.1115384615387,2.8364460501525843,16,1990,2013,2001.8615384615384,4.31617921655288,23,7
1868,1896,1878.3384615384616,4.770491416781751,28,2371,2391,2380.4615384615386,3.3094082480381517,20,1989,2024,1998.8153846153846,4.3509810998252485,35,7
1869,1934,1887.5961538461538,12.46099647004336,65,2364,2405,2381.9307692307693,5.635229042000543,41,1959,2024,1994.3461538461538,10.414358619658989,65,7
1854,1946,1891.4692307692308,21.758658139674058,92,2362,2407,2382.2346153846156,8.25058520482979,45,1954,2086,2000.373076923077,27.274297483845544,132,7
1846,1946,1888.053846153846,22.85063521111677,100,2339,2407,2380.642307692308,11.951597139741374,68,1954,2086,2006.7730769230768,26.748478940514087,132,7
1846,1929,1889.0923076923077,14.077801553669401,83,2339,2412,2381.353846153846,12.357519423747076,73,1963,2049,2006.4307692307693,14.135275002843041,86,7
1826,1915,1881.4538461538461,17.67274870884682,89,2351,2414,2380.326923076923,11.403990959353214,63,1966,2033,2004.0307692307692,12.791127753757648,67,7
1826,1908,1874.35,16.814586194144322,82,2351,2414,2378.0538461538463,11.227593930084286,63,1942,2033,1990.6576923076923,17.72032127699118,91,7
1843,1966,1896.6923076923076,28.004231934423878,123,2338,2450,2382.1115384615387,15.328042963760932,112,1942,2101,1999.4538461538461,36.47956248858365,159,7
1834,1966,1912.5961538461538,20.37454276473445,132,2338,2450,2385.7038461538464,15.001183499494513,112,1934,2101,2003.676923076923,33.94447325599949,167,7
1834,1940,1906.4538461538461,13.023952711191185,106,2359,2421,2385.223076923077,8.122864801345184,62,1934,2012,1989.7230769230769,10.995271278872137,78,7
1892,1922,1904.3384615384616,4.733114830888429,30,2368,2395,2384.95,3.1892374513722745,27,1977,2005,1990.426923076923,4.2633445000499695,28,7
1879,1946,1905.7730769230768,9.776184824551432,67,2361,2415,2385.7115384615386,6.995686863320477,54,1967,2015,1991.7615384615385,7.67566866897533,48,7
1822,1946,1891.9423076923076,28.765738322137693,124,2342,2446,2382.2076923076925,12.41819325069165,104,1949,2060,1993.15,17.52694010212933,111,7
1822,1950,1892.2346153846154,35.331671096581076,128,2342,2446,2382.5538461538463,13.828548355801836,104,1949,2060,2005.0576923076924,21.021237157751006,111,7
1847,1950,1913.2615384615385,23.29533528998126,103,2349,2424,2387.6769230769232,9.187632601088966,75,1961,2050,2012.9538461538461,10.43632025748446,89,7
1894,1978,1923.8115384615385,16.625301156690025,84,2295,2435,2385.5115384615383,19.56979050288225,140,1830,2037,1997.0115384615385,34.56251486679513,207,7
1891,1978,1924.0461538461539,20.646261934503585,87,2295,2435,2384.5576923076924,21.484135712615657,140,1830,2039,1986.446153846154,33.14052484035802,209,7
1891,1975,1913.7923076923078,14.489083177811192,84,2336,2432,2386.2615384615383,9.714101397646925,96,1959,2039,1988.9807692307693,10.468725965666659,80,7
1873,1946,1910.676923076923,10.068273028187196,73,2359,2427,2386.646153846154,7.548925657752802,68,1974,2011,1990.9,6.571084429464484,37,7
1860,1946,1900.7615384615385,16.159343542495275,86,2359,2427,2384.476923076923,8.734801812105568,68,1957,2012,1992.35,8.981996149311957,55,7
1860,1917,1889.5269230769231,9.296242346783016,57,2361,2397,2382.0576923076924,5.003525635516298,36,1957,2012,1989.5115384615385,8.331214362812469,55,7
1868,1937,1889.9923076923078,11.992594982835634,69,2355,2404,2381.673076923077,6.273438379870254,49,1961,2012,1985.0192307692307,8.736579083246147,51,7
1861,1937,1888.9538461538461,13.617421012591004,76,2355,2407,2381.523076923077,7.527776502222889,52,1949,2020,1985.876923076923,11.746692878627313,71,7
1861,1931,1895.7423076923078,13.700567107077685,70,2361,2407,2383.4423076923076,6.58069442046499,46,1949,2020,1990.7615384615385,9.421329490122366,71,7
1882,1931,1908.1653846153847,7.5234224892588575,49,2361,2401,2385.846153846154,4.638202185429125,40,1970,2011,1992.9615384615386,5.540867955584007,41,7
1900,1922,1911.9423076923076,3.230008077846274,22,2380,2393,2386.5576923076924,2.5650868074336843,13,1984,2005,1992.4846153846154,4.376551445396541,21,7
1900,1921,1912.553846153846,2.993071893302825,21,2379,2394,2386.6153846153848,2.5616253750157463,15,1980,2003,1991.926923076923,3.692636698291045,23,7
1907,1923,1913.1653846153847,2.883777326038137,16,2379,2394,2386.976923076923,2.533072011699197,15,1980,2004,1994.3076923076924,3.725827945812029,24,7
1878,1923,1909.6884615384615,9.337880131272051,45,2377,2397,2386.496153846154,3.2507772482212185,20,1973,2004,1992.9307692307693,5.938797847150538,31,7
1878,1920,1897.6923076923076,12.020796749781377,42,2376,2397,2383.757692307692,3.80394766262863,21,1972,2001,1985.8307692307692,6.924455527193769,29,7
1877,1899,1888.9076923076923,3.861394218461165,22,2376,2389,2381.742307692308,2.588759944776273,13,1972,1997,1984.053846153846,4.500212845179175,25,7
1877,1899,1888.5115384615385,3.7100330341312486,22,2374,2389,2381.7846153846153,2.7070182356141834,15,1976,2000,1988.003846153846,3.894851642857443,24,7
1878,1897,1888.6192307692309,3.32726182027673,19,2374,2391,2381.9576923076925,2.7498926727982878,17,1980,2002,1989.65,3.847051721748351,22,7
1878,1900,1888.0153846153846,3.866467295810137,22,2373,2391,2382.023076923077,2.9011125135805775,18,1972,2006,1990.5307692307692,4.915012793203163,34,7
1877,1900,1886.5653846153846,3.6875499926136523,23,2373,2391,2381.507692307692,3.0217899879400503,18,1972,2006,1989.8807692307691,4.695065941352069,34,7
1877,1895,1885.6423076923077,3.1041973175107582,18,2374,2388,2381.2615384615383,2.846263814409638,14,1979,1998,1987.9115384615384,3.3662906413310014,19,7
1873,1898,1885.5153846153846,3.900766413921579,25,2373,2391,2381.492307692308,3.107460580009223,18,1979,2012,1990.323076923077,5.579492766438499,33,7
1856,1929,1886.3961538461538,9.431360681289009,73,2339,2425,2381.4115384615384,8.673165775759424,86,1964,2049,1995.6038461538462,10.380445708333198,85,7
1816,1940,1886.9153846153847,14.024542533993516,124,2339,2425,2382.0346153846153,12.537001369003807,86,1953,2089,2012.2230769230769,23.82035902352238,136,7
1816,2008,1895.2961538461539,26.406401773964863,192,2322,2439,2384.15,16.030033347188304,117,1953,2111,2025.9653846153847,22.656635263717373,158,7
1824,2008,1910.0846153846153,29.2211735301131,184,2322,2439,2385.7961538461536,15.847998564773361,117,1972,2119,2025.003846153846,25.637734327421004,147,7
1851,1974,1907.9384615384615,21.980424371223034,123,2344,2431,2385.519230769231,11.06158678077888,87,1973,2119,2018.7307692307693,22.40114739943927,146,7
1861,1934,1894.126923076923,15.72014072687724,73,2346,2413,2383.853846153846,10.535552268289575,67,1945,2048,2010.9923076923078,13.52760435539418,103,7
1861,1923,1891.7615384615385,13.787859830484159,62,2346,2412,2383.146153846154,9.890607485089902,66,1945,2048,2007.576923076923,14.515530431252717,103,7
1867,1968,1905.8115384615385,22.555788013580305,101,2357,2427,2385.8153846153846,9.483401158597982,70,1962,2043,2011.4615384615386,14.556057978684475,81,7
1869,1968,1908.6038461538462,22.385719744302357,99,2357,2427,2386.623076923077,10.211860304669806,70,1984,2043,2014.4192307692308,12.524771415874184,59,7
1869,1940,1902.7384615384615,10.974912667019636,71,2357,2408,2385.423076923077,6.9464197434899715,51,1984,2035,2009.2230769230769,7.683674097646753,51,7
1896,1914,1904.3923076923077,3.260850384967889,18,2378,2394,2385.9692307692308,2.969441431916518,16,1993,2016,2004.426923076923,4.320915970059453,23,7
1888,1914,1902.6807692307693,3.8846812534297386,26,2372,2401,2385.642307692308,3.5312912397617136,29,1993,2027,2005.4730769230769,7.579389737778946,34,7
1888,1911,1899.4192307692308,4.301972182262998,23,2372,2401,2384.8884615384613,3.4404842663398405,29,1989,2027,2004.9307692307693,7.909418130235319,38,7
1890,1909,1898.1653846153847,3.305481852349257,19,2377,2392,2384.607692307692,2.8406757416922246,15,1987,2012,1998.7,4.712015365328174,25,7
1893,1909,1898.65,2.957321912770555,16,2378,2391,2384.730769230769,2.736253001292184,13,1987,2011,1997.2961538461539,4.30596073963731,24,7
1890,1908,1898.1807692307693,3.0073936214630095,18,2378,2391,2384.769230769231,2.6422128947700223,13,1987,2011,1997.196153846154,4.149241059061448,24,7
1888,1908,1897.65,3.2851308865987274,20,2378,2391,2384.473076923077,2.5925431667148904,13,1986,2005,1995.1615384615384,3.5495474640138567,19,7
1888,1906,1897.4,2.9750571844865856,18,2379,2391,2384.3153846153846,2.664030723745448,12,1982,2003,1992.5307692307692,3.970331014352376,21,7
1890,1907,1897.076923076923,2.8013107373766744,17,2379,2390,2384.3038461538463,2.6178745201531344,11,1980,2001,1990.7884615384614,3.6196404312855233,21,7
1888,1907,1896.2576923076922,3.3724609298689767,19,2375,2390,2384.1653846153845,2.7634462156218977,15,1978,2005,1990.9769230769232,4.614841567894039,27,7
1886,1907,1894.4846153846154,3.8519605706185827,21,2375,2391,2383.5384615384614,2.851955492929392,16,1978,2005,1989.8,4.70668628154626,27,7
1886,1902,1892.5884615384616,3.183551709176637,16,2376,2391,2382.996153846154,2.6877357336470737,15,1980,1999,1987.6615384615384,3.42724457049761,19,7
1883,1902,1891.9692307692308,2.977232685551209,19,2377,2390,2382.7923076923075,2.5625643341652844,13,1979,1995,1986.2884615384614,3.259299368427572,16,7
1883,1899,1891.5846153846153,2.9936473676644955,16,2373,2390,2382.4192307692306,2.5295961236641213,17,1978,1995,1986.0115384615385,3.1530859950136616,17,7
1884,1911,1892.4884615384615,4.546187415606623,27,2373,2397,2382.480769230769,3.3235464185055092,24,1976,1995,1985.3961538461538,3.570685102300692,19,7
1883,1911,1892.2653846153846,5.106846211692519,28,2373,2398,2382.326923076923,3.680907401589898,25,1976,2003,1989.0807692307692,6.0184092891104015,27,7
1853,1966,1896.6846153846154,18.687445299468084,113,2351,2439,2383.1961538461537,10.699654696886746,88,1973,2077,1998.6692307692308,17.74329541614331,104,7
1801,1966,1895.2769230769231,29.27014776767535,165,2340,2439,2382.980769230769,14.883966113991502,99,1957,2077,2006.996153846154,20.883848311197823,120,7
1801,1959,1890.873076923077,22.586326161908875,158,2340,2431,2382.5615384615385,10.898977208330338,91,1957,2068,2006.8307692307692,13.061564033623807,111,7
1882,1902,1894.6192307692309,3.4424691720615304,20,2375,2392,2383.8346153846155,3.083076524408834,17,1985,2020,2000.0307692307692,6.246467371111021,35,7
1885,1910,1897.9923076923078,4.189518367553023,25,2375,2394,2384.353846153846,2.841668818684133,19,1979,2007,1993.7615384615385,5.4052796243161945,28,7
1891,1910,1900.9807692307693,2.94538697377856,19,2379,2394,2384.5730769230768,2.7195925331165967,15,1979,1999,1989.0653846153846,4.219777145361963,20,7
1894,1913,1902.326923076923,3.2627602418204735,19,2379,2391,2384.6346153846152,2.6525200820847306,12,1975,1997,1985.3884615384616,4.1281430682045395,22,7
1894,1913,1904.5576923076924,3.4496570336967776,19,2375,2391,2384.8153846153846,2.635617678359391,16,1973,1993,1982.4653846153847,3.528531507657909,20,7
1899,1915,1906.5269230769231,2.8357967825186967,16,2375,2391,2384.630769230769,2.6410436147688614,16,1973,1990,1980.7307692307693,3.256803894429569,17,7
1901,1915,1907.9576923076922,2.766690044904525,14,2377,2392,2384.746153846154,2.622479414103813,15,1972,1989,1979.7307692307693,3.038462478335751,17,7
1899,1914,1907.9115384615384,2.9650248129437533,15,2377,2392,2384.8884615384613,2.6404672166241947,15,1968,1991,1979.9307692307693,4.073055755791123,23,7
1897,1914,1906.2192307692308,3.290623068386924,17,2377,2391,2384.480769230769,2.8222118479801823,14,1965,1991,1978.5423076923078,5.434245272438638,26,7
1894,1944,1909.0846153846153,11.332826965632494,50,2372,2406,2384.9846153846156,5.215783316472763,34,1965,1999,1977.5961538461538,7.406194880079959,34,7
1851,1944,1907.7076923076922,16.292190209896944,93,2349,2454,2385.119230769231,12.457077479440324,105,1943,2040,1977.4769230769232,12.381462906321842,97,7
1851,1942,1905.1346153846155,15.604707791461692,91,2349,2454,2384.7038461538464,13.275255838680383,105,1943,2040,1980.6884615384615,13.967939764093389,97,7
1867,1932,1909.7076923076922,11.842235880041853,65,2349,2411,2385.8346153846155,7.760878144980088,62,1955,2024,1991.2961538461539,12.166190914423515,69,7
1896,1931,1914.0923076923077,6.60986294035573,35,2372,2406,2386.8307692307694,5.155704508725164,34,1972,2024,1993.5884615384616,8.29545286072666,52,7
1903,1931,1915.0692307692307,4.435184806844498,28,2374,2406,2386.996153846154,3.8809484938299827,32,1972,2002,1990.9923076923078,4.682995038481519,30,7
1900,1924,1911.5384615384614,4.39313934444075,24,2377,2393,2386.6153846153848,3.046320941737965,16,1979,2002,1990.326923076923,4.705706524388648,23,7
1898,1919,1909.173076923077,3.8198887865421347,21,2377,2393,2385.95,3.0708179333726027,16,1976,1999,1987.176923076923,3.714659230493855,23,7
1898,1919,1909.3423076923077,3.6404710413666805,21,2378,2395,2385.5461538461536,2.925355902741948,17,1975,1997,1984.376923076923,3.6776805360626588,22,7
1901,1918,1908.6461538461538,3.287654545214933,17,2375,2395,2385.119230769231,2.9989083252829096,20,1975,1992,1983.0,3.1950734277155837,17,7
1898,1915,1906.503846153846,3.501238696329116,17,2375,2393,2384.9153846153845,2.9475062829098926,18,1971,1992,1982.3192307692307,3.509778863197462,21,7
1895,1915,1903.8653846153845,3.6856648428913523,20,2375,2393,2384.642307692308,3.074201164646322,18,1966,1992,1981.1153846153845,4.0444148349657905,26,7
1895,1914,1903.5461538461539,3.5545642820080268,19,2372,2392,2384.3038461538463,3.165326234259301,20,1966,1992,1979.373076923077,4.592595828280173,26,7
1896,1914,1905.0,3.2868052578588838,18,2372,2392,2384.269230769231,2.7824282096590998,20,1967,1988,1976.426923076923,3.705162598082556,21,7
1896,1914,1905.5923076923077,2.957083384746217,18,2376,2392,2384.1692307692306,2.7088827471940786,16,1966,1983,1974.5230769230768,3.1296696622538613,17,7
1899,1914,1905.7884615384614,2.902113052977118,15,2376,2395,2384.1769230769232,2.8716841132982656,19,1962,1982,1973.2038461538461,3.60726216989289,20,7
1899,1914,1905.923076923077,2.8409998365505182,15,2377,2395,2384.1,2.8115866170223716,18,1962,1981,1972.4653846153847,3.4889170701726804,19,7
1895,1915,1905.6,2.9763546930242133,20,2377,2392,2383.6923076923076,2.5296577632494874,15,1963,1980,1972.0153846153846,3.1005905911071223,17,7
1895,1915,1904.8307692307692,3.238614655778746,20,2377,2394,2383.576923076923,2.5251335363301832,17,1963,1981,1972.6692307692308,3.1473184309207265,18,7
1896,1913,1905.2076923076922,3.133321116276022,17,2377,2396,2384.142307692308,2.8715987874491793,19,1966,1985,1973.6884615384615,2.894386381855838,19,7
1896,1914,1905.4615384615386,2.9175380909301785,18,2377,2396,2384.357692307692,2.775885274203359,19,1965,1985,1972.7038461538461,3.306829340186803,20,7
1893,1914,1904.7307692307693,3.011659354922477,21,2375,2393,2383.7846153846153,2.764877943879267,18,1962,1982,1971.4538461538461,3.484353417883832,20,7
1893,1912,1904.2961538461539,3.0251176012407357,19,2375,2393,2383.742307692308,2.784218220950201,18,1962,1982,1971.9923076923078,3.4796621542972686,20,7
1895,1915,1904.6807692307693,2.9582055542135848,20,2377,2391,2383.9307692307693,2.7345592108809926,14,1963,1983,1972.8346153846153,3.2902620223660266,20,7
1898,1915,1905.423076923077,2.89951502965365,17,2377,2393,2384.0884615384616,2.9506660360722043,16,1963,1983,1973.696153846154,3.4957205795175295,20,7
1898,1916,1906.323076923077,2.9934687840121805,18,2376,2393,2384.1961538461537,2.916466467452807,17,1965,1983,1974.1538461538462,3.3240937185342787,18,7
1897,1916,1906.426923076923,3.0311201457034556,19,2376,2392,2384.023076923077,2.7197699897507506,16,1965,1981,1973.0961538461538,3.129505958423397,16,7
1897,1915,1906.9846153846154,3.2334750432562265,18,2378,2391,2384.3,2.75694980019082,13,1966,1982,1973.2961538461539,3.4080283104248075,16,7
1899,1915,1908.1115384615384,3.023565989349545,16,2378,2391,2384.65,2.7150019376117434,13,1962,1982,1973.4346153846154,3.6507197479065243,20,7
1891,1915,1907.1615384615384,3.426681243148295,24,2377,2391,2384.4615384615386,2.6087285802598945,14,1962,1982,1972.0884615384616,3.486856393396136,20,7
1891,1915,1905.8692307692309,3.249920608566302,24,2377,2390,2383.6923076923076,2.62552411784331,13,1960,1980,1969.8115384615385,3.712529856159804,20,7
1898,1915,1905.1038461538462,2.9994826798793732,17,2377,2393,2383.2846153846153,2.6251960482322634,16,1959,1976,1967.9730769230769,3.4377034729314815,17,7
1898,1912,1905.0192307692307,2.9766814761799103,14,2372,2393,2383.2653846153844,2.895001991542757,21,1959,1977,1968.5884615384616,3.4073310610953205,18,7
1898,1916,1906.0807692307692,3.0512380208783223,18,2372,2393,2383.396153846154,2.9891671557676873,21,1960,1981,1969.4,3.2145902901599657,21,7
1900,1916,1907.4192307692308,3.2139319344625954,16,2375,2393,2383.9307692307693,2.885694877708821,18,1960,1981,1968.4076923076923,3.409494247634248,21,7
1900,1915,1908.3615384615384,3.0466231604700775,15,2375,2393,2384.0576923076924,2.798327282616453,18,1960,1977,1967.1615384615384,3.171552720474099,17,7
1899,1917,1909.2230769230769,3.0498189948578758,18,2376,2391,2383.9076923076923,2.60218546060214,15,1960,1976,1967.4923076923078,3.204114521416153,16,7
1899,1919,1909.8346153846153,3.0818239481902348,20,2376,2391,2383.9384615384615,2.5792574614739516,15,1959,1976,1967.2,3.350560374960408,17,7
1901,1919,1910.4769230769232,3.236412964126932,18,2377,2391,2383.9307692307693,2.6103105971744847,14,1959,1977,1966.5269230769231,3.2339962598512404,18,7
1901,1918,1910.0230769230768,3.307801436233793,17,2377,2391,2383.723076923077,2.7170713981191192,14,1955,1977,1965.4384615384615,3.6687216928405544,22,7
1903,1918,1909.7307692307693,3.076347585029114,15,2378,2391,2383.9269230769232,2.813104701847776,13,1955,1977,1965.3846153846155,3.742451069277995,22,7
1902,1920,1910.373076923077,3.0711080706651765,18,2377,2391,2384.4615384615386,2.7415122680538047,14,1958,1980,1969.0961538461538,4.246550339180001,22,7
1902,1920,1909.946153846154,3.0914292741279006,18,2377,2392,2384.373076923077,2.8601992117227657,15,1959,1982,1970.2884615384614,3.7402978143227763,23,7
1902,1918,1909.7076923076922,2.9850235024812304,16,2377,2392,2384.3115384615385,2.793929840930863,15,1959,1982,1969.1692307692308,3.2576336522354703,23,7
1902,1917,1909.7269230769232,2.9102478622176875,15,2378,2391,2384.346153846154,2.5474994582440034,13,1960,1981,1968.45,3.44977756543306,21,7
1903,1924,1909.5269230769231,3.160330574115521,21,2376,2395,2384.346153846154,2.883079484188272,19,1957,1990,1968.7076923076922,5.352365556258004,33,7
1898,1924,1908.0961538461538,3.5892353827257737,26,2376,2395,2385.276923076923,3.175717192254324,19,1957,2009,1983.3115384615385,14.764269373512871,52,7
1894,1916,1905.05,3.82349473245511,22,2378,2393,2385.269230769231,2.844186542651007,15,1973,2009,1991.373076923077,7.3271093233642315,36,7
1894,1912,1903.5576923076924,3.1267525528224205,18,2377,2394,2384.7,2.5457967477945056,17,1973,1995,1984.503846153846,4.152031718251607,22,7
1898,1914,1904.2884615384614,2.8967865198133156,16,2377,2394,2384.8038461538463,2.5217173729540963,17,1973,1991,1982.15,3.5970547797890275,18,7
1897,1914,1903.9538461538461,3.132496354751816,17,2378,2398,2384.4846153846156,2.6790611372957835,20,1967,1990,1978.9,4.055312545977172,23,7
1896,1913,1904.1923076923076,3.1058449166487123,17,2378,2398,2384.380769230769,2.669218101752885,20,1967,1984,1976.0807692307692,3.060082926018103,17,7
1896,1913,1905.3384615384616,3.125567367562467,17,2375,2390,2384.480769230769,2.5201150967723875,15,1967,1984,1975.5269230769231,3.0773876616888587,17,7
1897,1915,1906.553846153846,3.372753737744245,18,2375,2391,2384.5576923076924,2.599476198636277,16,1967,1986,1976.496153846154,3.418661117637113,19,7
1898,1915,1907.253846153846,3.013000245298775,17,2378,2391,2384.903846153846,2.7259627988791744,13,1967,1986,1977.8,3.266537964002603,19,7
1898,1915,1907.3153846153846,3.0058748535632076,17,2377,2391,2385.1846153846154,2.7865773567251573,14,1967,1985,1977.0961538461538,3.478891756391373,18,7
1899,1920,1908.45,3.3406066080358086,21,2376,2391,2385.0115384615383,2.7361200332501565,15,1965,1985,1975.446153846154,3.277539190042301,20,7
1900,1920,1909.5923076923077,3.3500905395386886,20,2376,2398,2385.130769230769,2.770190079029429,22,1965,1985,1974.9076923076923,3.5027758520120393,20,7
1903,1921,1911.7307692307693,3.7194852916191015,18,2377,2398,2385.619230769231,2.873997287726697,21,1964,1986,1976.5230769230768,4.183466971471856,22,7
1905,1924,1914.946153846154,3.7164177929507884,19,2377,2394,2386.15,2.8196429029907497,17,1964,1990,1978.8,4.027703293738731,26,7
1906,1924,1916.0115384615385,3.259062437494558,18,2378,2394,2386.126923076923,2.724698657463385,16,1967,1990,1977.753846153846,4.370949268202218,23,7
1906,1924,1915.7423076923078,3.059092791670221,18,2378,2392,2385.7961538461536,2.7341654715215804,14,1965,1983,1975.3884615384616,3.883320129756911,18,7
1908,1924,1916.0230769230768,3.0818070831145317,16,2378,2393,2385.9653846153847,2.797329436275244,15,1965,1987,1975.8615384615384,4.0082036457366375,22,7
1907,1923,1915.2615384615385,3.1758107131524205,16,2378,2393,2385.85,2.719264890444023,15,1969,1987,1976.4653846153847,3.7150889561201557,18,7
1905,1922,1913.4923076923078,3.0025630077293326,17,2378,2393,2385.2076923076925,2.5413830601914107,15,1964,1984,1974.9923076923078,3.6028649129041153,20,7
1905,1920,1912.9730769230769,2.879035887037124,15,2378,2392,2385.130769230769,2.622705907757535,14,1963,1982,1972.9692307692308,3.411175052106713,19,7
1907,1920,1913.2384615384615,2.8523616068035156,13,2373,2392,2385.396153846154,2.7086278235787002,19,1962,1982,1972.5153846153846,3.3258891234583365,20,7
1903,1920,1912.9153846153847,2.982664496098664,17,2373,2393,2385.5307692307692,2.8207407815285963,20,1962,1993,1974.1115384615384,5.57911348482062,31,7
1903,1920,1912.0692307692307,3.452241086304449,17,2378,2394,2386.4461538461537,3.0059440173927787,16,1963,2012,1988.003846153846,14.002343454422986,49,7
1902,1919,1910.6115384615384,3.396435438187172,17,2378,2394,2386.9846153846156,2.6493522640576543,16,1988,2012,1997.9346153846154,4.6415483293800675,24,7
1902,1917,1909.8153846153846,2.876571896314409,15,2379,2394,2386.4384615384615,2.5695089029571396,15,1983,2002,1993.0269230769231,3.9926629323494485,19,7
1902,1919,1910.5153846153846,3.1555176052894014,17,2379,2394,2386.4846153846156,2.879120992479769,15,1983,2002,1991.2269230769232,3.5246575114769056,19,7
1903,1919,1910.3807692307691,3.3016339970970514,16,2379,2394,2386.480769230769,2.95846657958553,15,1979,2002,1989.573076923077,3.7620393808332606,23,7
1902,1917,1909.1576923076923,2.941209411230829,15,2379,2394,2385.9692307692308,2.7870036539964147,15,1979,1999,1987.8807692307691,3.5982105409660363,20,7
1902,1916,1908.5461538461539,2.9001705141230945,14,2379,2392,2385.980769230769,2.5866481091846336,13,1977,1999,1987.123076923077,3.9210655407369788,22,7
1901,1918,1908.2269230769232,3.0653194851733723,17,2378,2392,2385.6961538461537,2.7034913461791326,14,1977,1996,1985.9692307692308,3.3747608787899313,19,7
1896,1918,1906.8153846153846,3.3433726651602536,22,2378,2392,2385.0423076923075,2.659966771488551,14,1979,1995,1986.0153846153846,3.150006717856697,16,7
1896,1914,1906.1653846153847,3.3426508228222884,18,2378,2392,2385.1576923076923,2.6701081025826046,14,1979,1993,1986.1115384615384,3.0628962651930496,14,7
1897,1920,1906.6384615384616,3.175689135447846,23,2378,2392,2385.3115384615385,2.7814647016537686,14,1974,1994,1985.0807692307692,3.3676314363275397,20,7
1899,1920,1907.4884615384615,3.1835517091766365,21,2379,2398,2385.5615384615385,2.8515493212170697,19,1974,1997,1985.6076923076923,4.062249512507953,23,7
1902,1916,1908.7769230769231,2.925761979396677,14,2379,2398,2385.873076923077,2.9440152882120056,19,1977,1997,1986.1038461538462,3.808239468926272,20,7
1902,1916,1909.1346153846155,2.7581318600261584,14,2379,2398,2385.9346153846154,2.76484303249877,19,1977,1996,1985.4192307692308,3.129942482944367,19,7
1902,1918,1909.503846153846,3.006425649936347,16,2379,2398,2386.05,2.496600004608584,19,1977,1996,1985.5576923076924,3.084482657437591,19,7
1901,1918,1908.326923076923,3.4714564380112565,17,2379,2392,2385.4307692307693,2.62138064226401,13,1976,1994,1984.4807692307693,3.238823280139909,18,7
1895,1915,1906.9346153846154,3.1105055899716727,20,2375,2395,2385.1807692307693,2.8410285851155077,20,1976,1994,1984.3192307692307,3.364878700994833,18,7
1892,1915,1907.5115384615385,3.200485837042494,23,2375,2395,2385.3846153846152,2.919471617144877,20,1974,1994,1983.0384615384614,3.842264145395754,20,7
1892,1915,1907.4884615384615,2.9909550808750534,23,2378,2393,2385.4307692307693,2.6940187188913254,15,1972,1993,1981.3615384615384,3.2903364913507294,21,7
1898,1917,1907.0961538461538,2.960874957977881,19,2379,2392,2385.1923076923076,2.5028050791128873,13,1972,1993,1981.5461538461539,3.3383498535323923,21,7
1898,1917,1907.0807692307692,3.193443963510922,19,2371,2393,2384.7192307692308,2.92275313574135,22,1973,1990,1980.8615384615384,3.1223539435967456,17,7
1899,1916,1907.7769230769231,3.121145677720017,17,2371,2395,2385.0307692307692,3.0616281572991477,24,1973,1989,1981.1538461538462,3.088055300036827,16,7
1900,1916,1908.7346153846154,2.9096354781963005,16,2379,2395,2385.4192307692306,2.6474318043898997,16,1971,1989,1980.5192307692307,3.340926654655997,18,7
1901,1919,1909.1615384615384,2.776914890891745,18,2379,2394,2385.4615384615386,2.5260155147493415,15,1970,1989,1979.826923076923,3.234235027062228,19,7
1901,1919,1910.1,2.912759839768786,18,2379,2394,2385.7115384615386,2.569020503979357,15,1970,1991,1981.1846153846154,3.2556090365690715,21,7
1902,1918,1910.0846153846153,2.9696914686659652,16,2379,2394,2385.5461538461536,2.4718071748885895,15,1972,1991,1980.923076923077,3.3395151073713008,19,7
1901,1916,1908.8076923076924,2.965948717839167,15,2379,2391,2385.242307692308,2.3626228924623014,12,1972,1993,1981.2807692307692,3.5999269866865786,21,7
1901,1921,1909.4423076923076,3.373834485086536,20,2378,2391,2385.2115384615386,2.526588635621187,13,1972,1993,1981.0961538461538,3.9341079328362643,21,7
1900,1921,1909.9730769230769,3.2966647111889045,21,2375,2391,2385.257692307692,2.7068728594377456,16,1972,1991,1981.376923076923,3.889924386348883,19,7
1900,1917,1909.3,3.348831410308948,17,2375,2392,2385.503846153846,2.6675485498515794,17,1975,1992,1983.076923076923,3.118299171630221,17,7
1900,1917,1909.0423076923078,3.354553532592587,17,2378,2392,2385.507692307692,2.651570974126212,14,1975,1992,1982.7615384615385,3.2210788527058716,17,7
1900,1921,1909.6115384615384,3.5498465813906313,21,2377,2392,2385.6692307692306,2.853943858066508,15,1975,1997,1983.7730769230768,3.7383598175314967,22,7
1891,1927,1908.7076923076922,6.5676710890774315,36,2377,2399,2386.019230769231,3.3993548366731745,22,1977,2045,1999.7961538461539,19.570109206112633,68,7
1868,1932,1904.2346153846154,10.840843771307364,64,2322,2427,2385.9192307692306,9.950321359579055,105,1948,2051,2011.2269230769232,15.777361663951964,103,7
1868,1932,1896.9076923076923,10.208593664917055,64,2322,2427,2384.7846153846153,9.869014428880211,105,1948,2051,2004.2269230769232,9.955811934151392,103,7
1882,1901,1891.8,3.0106631601845906,19,2376,2391,2383.6,2.7679913406251946,15,1991,2008,1999.5384615384614,3.3257015891825077,17,7
1884,1900,1890.6807692307693,2.7470615021049123,16,2376,2390,2383.2076923076925,2.4390521415040207,14,1988,2006,1997.9115384615384,3.2708879602805183,18,7
1882,1900,1890.2153846153847,2.9421307000425823,18,2376,2391,2383.026923076923,2.568604280096089,15,1986,2006,1996.5923076923077,3.3397018659767452,20,7
1882,1900,1891.0923076923077,3.0905164538134966,18,2373,2391,2382.973076923077,2.802929754099308,18,1986,2005,1996.4923076923078,3.4186546019156845,19,7
1884,1902,1892.1307692307691,3.0916214124829313,18,2373,2390,2383.2346153846156,2.8000885683306502,17,1988,2005,1996.2076923076922,3.4477817922831613,17,7
1885,1902,1893.3153846153846,3.0706849446183875,17,2377,2393,2383.257692307692,2.682514966572702,16,1986,2005,1994.25,3.643765501102812,19,7
1884,1903,1893.8692307692309,3.039986947590506,19,2375,2393,2383.3346153846155,2.817408967081863,18,1986,2014,1995.573076923077,5.592884178163664,28,7
1875,1903,1890.9576923076922,5.08861042367718,28,2375,2390,2383.103846153846,2.9994826798793732,15,1986,2014,1998.3153846153846,5.236543136591545,28,7
1875,1905,1890.1384615384616,5.346313775216619,30,2374,2393,2382.9346153846154,3.114227199227932,19,1987,2010,2000.1461538461538,4.25556467578989,23,7
1859,1918,1893.0884615384616,8.84987738165505,59,2359,2415,2383.0653846153846,6.373778469248203,56,1978,2024,2003.2192307692308,8.011214110829364,46,7
1859,1918,1898.2076923076922,9.557948564120899,59,2359,2420,2385.107692307692,8.39538957300768,61,1978,2024,2003.5153846153846,9.094726390279595,46,7
1889,1913,1902.9769230769232,3.962108920550658,24,2366,2420,2386.5692307692307,5.81230018003487,54,1984,2018,2002.0692307692307,5.8918023824068735,34,7
1896,1916,1904.423076923077,3.395125701189652,20,2376,2393,2385.8423076923077,2.6351753440993435,17,1992,2012,2000.9769230769232,3.9922035691694555,20,7
1896,1916,1904.1115384615384,3.3667493944458484,20,2378,2392,2385.7923076923075,2.5322511353133623,14,1988,2007,1997.0576923076924,4.54073566377524,19,7
1894,1915,1902.9,3.16313221434157,21,2378,2393,2385.3423076923077,2.7259192175549845,15,1985,2002,1994.0461538461539,3.593992281124226,17,7
1894,1958,1906.5461538461539,11.217134947218762,64,2369,2407,2385.75,4.471596330749652,38,1985,2077,2001.003846153846,18.916907939708487,92,7
1868,1959,1908.496153846154,15.542816209720032,91,2332,2435,2385.7192307692308,14.065004058809908,103,1948,2105,2016.5269230769231,32.11254409986055,157,7
1867,1959,1895.9923076923078,17.897173545250684,92,2331,2438,2383.55,18.071538449465276,107,1948,2105,2021.5615384615385,28.12328178429712,157,7
1867,1925,1880.8884615384616,10.049254257780081,58,2331,2438,2381.0115384615383,12.132945254898354,107,1975,2064,2012.0461538461539,12.773864206715475,89,7
1867,1888,1877.1615384615384,3.2222772976686818,21,2372,2392,2380.269230769231,2.8401111010365536,20,1998,2017,2007.6538461538462,3.509967139428704,19,7
1867,1888,1878.446153846154,3.0782874907737052,21,2374,2392,2380.6576923076923,2.7245024450188278,18,1998,2019,2008.876923076923,3.634913040581963,21,7
1867,1888,1877.9884615384615,3.214929810396128,21,2371,2389,2380.5384615384614,2.648388002910263,18,1994,2019,2007.1692307692308,4.9259198800515085,25,7
1866,1886,1875.4192307692308,3.597137346473872,20,2371,2388,2379.8038461538463,2.7177353690316384,17,1994,2019,2004.7846153846153,4.73544853466626,25,7
1862,1882,1872.4153846153847,3.4490995196264627,20,2371,2386,2379.146153846154,2.544162941473103,15,1994,2013,2003.9692307692308,3.597378843148792,19,7
1862,1879,1870.1423076923077,3.264252748386069,17,2370,2386,2378.3038461538463,2.561216646406686,16,1995,2016,2005.4538461538461,3.887633176328718,21,7
1861,1882,1868.95,3.2705247356245524,21,2370,2385,2377.726923076923,2.6020570556198264,15,1995,2016,2006.5923076923077,3.638481914006257,21,7
1861,1882,1869.0461538461539,3.1139530016850445,21,2372,2385,2377.9653846153847,2.5700145437282558,13,1997,2015,2006.8807692307691,3.3836444256229994,18,7
1857,1879,1869.6115384615384,3.1462212332746167,22,2369,2385,2378.0692307692307,2.657221417350399,16,1996,2015,2006.5461538461539,3.9847422097508995,19,7
1857,1879,1870.9884615384615,3.5133311391748565,22,2369,2388,2378.626923076923,2.747277724864179,19,1996,2017,2006.3307692307692,3.900081103083961,21,7
1865,1884,1872.5115384615385,3.2744272891414266,19,2371,2388,2378.992307692308,2.522473976649702,17,1997,2017,2005.5653846153846,3.3403398790947167,20,7
1864,1884,1872.5615384615385,3.366892741975416,20,2371,2387,2378.6692307692306,2.6881362737176526,16,1998,2013,2005.673076923077,3.4491404214049686,15,7
1864,1885,1873.25,3.276657822612316,21,2371,2387,2378.776923076923,2.6690428478744446,16,1999,2015,2007.1846153846154,3.2017963475992426,16,7
1867,1885,1874.8846153846155,3.067162272766866,18,2373,2387,2379.4,2.4639485528400282,14,2001,2017,2008.076923076923,3.3023108432212895,16,7
1864,1884,1875.5615384615385,3.143919414398099,20,2373,2387,2379.6653846153845,2.5346162972489097,14,2001,2017,2008.2192307692308,3.3740457516436755,16,7
1864,1884,1875.15,3.2413532137628343,20,2371,2386,2379.357692307692,2.6154682545720545,15,1996,2015,2006.2576923076922,3.496128369055343,19,7
1864,1884,1874.2423076923078,3.1498817869493565,20,2371,2385,2378.9576923076925,2.6439518037364333,14,1996,2013,2005.4576923076922,3.032981264197877,17,7
1864,1886,1873.373076923077,3.365055225935627,22,2371,2385,2378.6961538461537,2.7361417427596177,14,1997,2015,2006.2,3.411087984136621,18,7
1864,1886,1872.073076923077,3.556283002960928,22,2371,2386,2378.8307692307694,2.6773422583154303,15,1997,2016,2006.8384615384616,3.8097696930844935,19,7
1862,1882,1870.3923076923077,3.3737486542687174,20,2371,2386,2378.269230769231,2.746112623534319,15,1994,2016,2004.7038461538461,4.474809870142348,22,7
1862,1884,1870.8692307692309,3.4827505695285628,22,2371,2387,2378.103846153846,2.877281638760729,16,1994,2015,2003.7307692307693,4.009233477106699,21,7
1865,1884,1872.1538461538462,2.9746977743674816,19,2371,2387,2378.7653846153844,2.7246114536769412,16,1996,2015,2006.1576923076923,3.4588226484533884,19,7
1865,1882,1872.1,2.9509503737115113,17,2372,2388,2378.757692307692,2.634589207269378,16,1993,2016,2006.6884615384615,3.393023380792956,23,7
1863,1882,1871.35,3.240161824453934,19,2370,2388,2378.3153846153846,2.7524215112922246,18,1990,2016,2003.753846153846,4.726596951371964,26,7
1863,1878,1871.0,3.052943386383593,15,2370,2385,2378.3,2.7287968129437647,15,1990,2015,2003.3461538461538,4.7455917987793175,25,7
1860,1878,1871.35,3.0333729331144483,18,2371,2385,2378.596153846154,2.7875870427022584,14,1996,2015,2004.7692307692307,4.023173148886608,19,7
1860,1879,1871.6153846153845,3.0614923440595723,19,2368,2386,2378.2076923076925,2.986963060024064,18,1991,2013,2001.2269230769232,4.498653397171468,22,7
1862,1879,1871.446153846154,2.937078995606524,17,2368,2386,2377.923076923077,2.995789541131849,18,1984,2009,1996.8807692307691,3.902926258954092,25,7
1862,1881,1871.2153846153847,2.953917928045924,19,2370,2385,2378.0538461538463,2.794952810292369,15,1984,2008,1996.0653846153846,3.95529480498698,24,7
1863,1881,1872.15,2.9742459542107467,18,2371,2385,2378.4384615384615,2.721298367593088,14,1988,2009,1997.9730769230769,4.332160213751578,21,7
1865,1882,1873.9038461538462,2.9042613836798825,17,2371,2385,2379.0384615384614,2.6491168373290024,14,1985,2012,1999.503846153846,5.509905490029617,27,7
1824,1973,1898.2346153846154,33.01027618527803,149,2337,2416,2382.603846153846,8.758051156133998,79,1937,2043,1995.1346153846155,15.251088759354472,106,7
1824,2044,1931.2846153846153,36.5760929188804,220,2337,2430,2386.6576923076923,12.765865231832706,93,1937,2091,2014.3153846153846,34.437013089231044,154,7
1846,2044,1928.676923076923,29.390386730950514,198,2342,2430,2387.576923076923,10.189983259837025,88,1975,2091,2030.05,22.25131552225716,116,7
1907,1925,1917.45,3.456486264589706,18,2381,2398,2388.153846153846,2.7912204841093784,17,2001,2031,2017.7692307692307,5.7314932478381975,30,7
1904,1927,1917.0846153846153,3.703352577708517,23,2379,2398,2388.3192307692307,2.8437453185697623,19,2001,2026,2013.45,4.0165439724501315,25,7
1899,1927,1912.926923076923,5.768912673143305,28,2379,2396,2387.4538461538464,2.8774493704867994,17,2001,2022,2011.6346153846155,3.6709695212596394,21,7
1899,1925,1911.3346153846153,5.4212111875051265,26,2378,2396,2386.8884615384613,2.824168572505566,18,2000,2018,2008.6192307692309,3.751603953582017,18,7
1901,1925,1911.0884615384616,4.283832128038831,24,2376,2396,2386.726923076923,3.0081045857305555,20,1996,2018,2006.2961538461539,3.6498247452748567,22,7
1902,1920,1910.8,3.453832296009395,18,2376,2396,2387.0576923076924,2.9092679859098944,20,1996,2015,2006.6307692307691,3.4866285372231087,19,7
1904,1920,1911.7884615384614,3.0927523850313836,16,2379,2396,2387.5576923076924,2.630482592498698,17,2000,2014,2007.8115384615385,2.905038483264652,14,7
1899,1920,1911.3615384615384,3.693893209724267,21,2379,2394,2387.3038461538463,2.553668081646609,15,1993,2017,2006.7307692307693,3.773077687527151,24,7
1896,1920,1910.3346153846153,4.033588925490502,24,2380,2394,2386.9884615384617,2.692019798770172,14,1991,2017,2004.4038461538462,4.619329939310363,26,7
1896,1921,1909.7423076923078,4.696887417295779,25,2380,2395,2386.726923076923,2.995241746749855,15,1991,2013,2003.326923076923,4.441473345263425,22,7
1897,1921,1910.75,4.57065932234362,24,2380,2395,2386.880769230769,3.0309241720144264,15,1991,2013,2002.8,4.047784083243076,22,7
1903,1920,1911.0461538461539,3.127562210675494,17,2381,2395,2387.0346153846153,2.823432329943489,14,1991,2010,2001.3807692307691,3.485936359395034,19,7
1896,1925,1913.4692307692308,4.911869575473552,29,2381,2396,2387.2884615384614,2.852463126237723,15,1993,2009,2000.576923076923,3.248677508449485,16,7
1896,1925,1913.9692307692308,4.84977165650973,29,2378,2396,2387.1807692307693,3.0176468408666475,18,1990,2009,1999.373076923077,3.32929638725879,19,7
1901,1921,1911.8,3.4583009643241813,20,2378,2394,2386.876923076923,2.8024131482562407,16,1984,2005,1996.1423076923077,4.030642578557369,21,7
1901,1929,1913.376923076923,5.154396683202134,28,2378,2394,2387.1961538461537,2.5837300218213253,16,1984,2004,1994.6115384615384,3.647480425459944,20,7
1901,1933,1916.423076923077,6.73533342639519,32,2378,2395,2387.3038461538463,2.8495045656528206,17,1987,2013,1996.253846153846,4.3144930194462034,26,7
1899,1933,1913.1538461538462,7.50491374525586,34,2379,2395,2386.6923076923076,3.1496672713802516,16,1984,2013,1994.7230769230769,4.851486075102879,29,7
1898,1919,1906.8692307692309,3.890168702435992,21,2377,2394,2385.5807692307694,3.092713972367913,17,1978,2004,1991.0807692307692,3.9432772790454007,26,7
1898,1917,1906.8538461538462,3.5480410353595393,19,2377,2392,2385.523076923077,2.744500670847783,15,1978,2004,1991.6576923076923,4.2456130505770515,26,7
1898,1917,1907.95,3.301076225582234,19,2377,2394,2385.6884615384615,2.736684424525714,17,1982,2002,1992.5115384615385,3.4945989129257113,20,7
1898,1916,1907.3923076923077,3.1805299425993017,18,2377,2396,2385.603846153846,2.9956185210621067,19,1982,2002,1991.0576923076924,3.3323815590005377,20,7
1895,1916,1905.123076923077,3.4940995705234,21,2378,2396,2385.2115384615386,2.8348121253726473,18,1980,1998,1988.6307692307691,3.6542427058817197,18,7
1895,1918,1905.123076923077,4.481649214873882,23,2378,2391,2384.923076923077,2.522838949421141,13,1977,1995,1986.7961538461539,3.18793342353938,18,7
1896,1918,1906.1307692307691,4.330708274062588,22,2377,2393,2385.2115384615386,2.7123095521387497,16,1977,1997,1987.3923076923077,3.3427063546901294,20,7
1898,1916,1906.2923076923078,3.518173784443682,18,2377,2397,2385.4307692307693,2.9090153080329544,20,1980,1999,1989.253846153846,3.30160026359405,19,7
1897,1916,1906.5269230769231,3.5296928773948326,19,2376,2397,2385.7192307692308,3.008677184767153,21,1982,2001,1990.7192307692308,3.190540946227071,19,7
1892,1916,1905.5,4.4361623820073,24,2376,2393,2385.6923076923076,2.9963843175265383,17,1981,2002,1991.0961538461538,3.714001554093313,21,7
1892,1916,1904.746153846154,4.683515061928737,24,2379,2395,2385.55,2.6641840116396702,16,1981,2002,1991.7692307692307,3.6392083265234,21,7
1894,1916,1904.8461538461538,3.9199746639744197,22,2379,2395,2385.507692307692,2.4518408617860197,16,1980,2003,1991.0961538461538,3.792186721494622,23,7
1890,1915,1906.076923076923,3.7470511125940145,25,2379,2392,2385.6961538461537,2.567239517598376,13,1980,2003,1990.5576923076924,3.5565669400657143,23,7
1890,1917,1907.1615384615384,4.455362213137384,27,2378,2392,2385.5615384615385,2.8010032569811925,14,1979,1999,1990.0576923076924,3.444056272990267,20,7
1895,1917,1904.873076923077,4.927588216473211,22,2378,2391,2385.3346153846155,2.6840645585012584,13,1979,1997,1988.2769230769231,3.3032460567500133,18,7
1895,1913,1903.8692307692309,3.489395875489563,18,2377,2393,2385.4192307692306,2.6225218831538903,16,1979,1998,1988.2692307692307,3.474759426773755,19,7
1895,1914,1906.15,3.4221344013647186,19,2377,2393,2385.496153846154,2.6311147965767425,16,1979,1998,1988.7769230769231,3.3003226345509757,19,7
1896,1922,1907.2076923076922,3.597931953930528,26,2379,2393,2385.776923076923,2.6472551082129594,14,1980,1999,1989.1615384615384,3.219879961679778,19,7
1899,1922,1907.6423076923077,3.408899671535812,23,2378,2395,2385.8230769230768,2.709814521899007,17,1979,1999,1989.0307692307692,3.5038609956791773,20,7
1901,1922,1909.95,4.738876428748676,21,2378,2395,2386.2807692307692,2.7833647078884756,17,1979,1999,1989.3923076923077,3.3645807941560744,20,7
1900,1922,1910.2884615384614,4.698379489224963,22,2375,2394,2386.4653846153847,2.9933571638190974,19,1979,1999,1990.246153846154,3.736621517138224,20,7
1900,1927,1911.4846153846154,5.020013406409847,27,2375,2395,2386.653846153846,2.9636446789704367,20,1979,2002,1991.7038461538461,4.1711438177603934,23,7
1903,1927,1914.3346153846153,4.016322133599779,24,2378,2395,2387.026923076923,2.812555645755167,17,1981,2002,1991.9923076923078,3.8050893654032723,21,7
1906,1922,1914.3423076923077,3.6605665613054423,16,2378,2395,2386.826923076923,2.7713450579733716,17,1981,1998,1990.9769230769232,3.456213440372476,17,7
1901,1924,1915.0461538461539,3.7762957856092076,23,2380,2395,2386.7192307692308,2.626346939705082,15,1982,1998,1990.5076923076922,3.267356159896909,16,7
1901,1925,1914.4076923076923,4.426484270136176,24,2379,2394,2386.519230769231,2.6602347315319426,15,1980,1999,1989.7807692307692,3.711873802812688,19,7
1901,1925,1913.7615384615385,4.405689277524916,24,2379,2393,2386.6846153846154,2.668375108605557,14,1980,2000,1990.696153846154,3.945084500196632,20,7
1895,1923,1911.5461538461539,5.387833481906213,28,2379,2393,2386.75,2.7232376256990807,14,1980,2030,1998.003846153846,12.252648622946724,50,7
1861,1925,1903.5346153846153,12.211882380700827,64,2362,2403,2385.8307692307694,5.8995955120014125,41,1981,2030,2007.4115384615384,12.277198217818107,49,7
1861,1957,1906.35,20.52112105286671,96,2352,2421,2386.1384615384613,8.748527815394938,69,1977,2034,2009.1461538461538,9.545753701065921,57,7
1868,1957,1901.1,21.049619628071348,89,2352,2421,2384.9076923076923,7.41432002088805,69,1977,2034,2003.45,9.131461588025804,57,7
1877,1904,1886.5269230769231,4.324131594680491,27,2375,2391,2382.1,2.7839861979864686,16,1986,2013,1998.5230769230768,5.0819012412403515,27,7
1878,1895,1886.2576923076922,3.1104101055409115,17,2375,2389,2382.246153846154,2.432284587791551,14,1986,2012,2000.3615384615384,5.23723503660384,26,7
1877,1895,1886.1,3.2533914588558175,18,2374,2389,2382.5153846153844,2.523203869400522,15,1991,2012,2002.6,4.085193151957823,21,7
1877,1892,1884.8,2.9654379767282935,15,2374,2389,2382.1346153846152,2.530347437143396,15,1989,2011,2001.6307692307691,3.814498781019722,22,7
1875,1892,1884.5346153846153,3.0343518842236072,17,2371,2389,2381.896153846154,2.6172845088331913,18,1989,2009,1999.6346153846155,3.6898527565491506,20,7
1865,1915,1886.0230769230768,9.184059872788055,50,2363,2403,2381.6961538461537,5.965472130255722,40,1960,2010,1993.8923076923077,9.575746513714808,50,7
1865,1915,1892.446153846154,10.436838186327854,50,2363,2403,2382.4576923076925,6.160195621732325,40,1960,2010,1984.2692307692307,10.45105412025659,50,7
1888,1910,1897.7653846153846,3.7202817084860644,22,2374,2394,2383.173076923077,3.170332758719469,20,1967,1995,1977.9384615384615,4.886754370783156,28,7
1889,1910,1896.446153846154,3.8435857182000213,21,2374,2393,2382.523076923077,2.937483451665563,19,1967,1985,1974.7269230769232,3.519176115882883,18,7
1887,1906,1894.5384615384614,3.0164384792170216,19,2374,2389,2381.9192307692306,2.7434047598321465,15,1966,1982,1972.6884615384615,3.29018980840756,16,7
1886,1904,1894.3538461538462,3.2557914859797457,18,2375,2390,2381.973076923077,2.7047873605654598,15,1959,1983,1972.6423076923077,3.6622537817719243,24,7
1886,1904,1894.4192307692308,3.3063083766755756,18,2374,2390,2381.8230769230768,2.752227275272697,16,1959,1983,1972.5576923076924,3.7116817652624157,24,7
1887,1905,1894.9076923076923,3.0248549634234614,18,2374,2388,2381.6653846153845,2.5858901826697975,14,1961,1980,1971.5423076923078,3.457706191354625,19,7
1889,1905,1895.4923076923078,2.9296675891561796,16,2373,2389,2381.5307692307692,2.527649301032679,16,1962,1982,1970.7615384615385,3.6461305371952735,20,7
1889,1903,1895.55,2.8652828062593683,14,2373,2390,2381.6653846153845,2.769029255447298,17,1959,1982,1971.073076923077,3.9375489399233703,23,7
1888,1905,1896.4346153846154,3.2070677628144426,17,2375,2390,2381.9692307692308,2.6825288061753962,15,1959,1983,1971.8692307692309,3.5832912580442353,24,7
1888,1907,1897.4538461538461,3.016330170629154,19,2376,2388,2382.0423076923075,2.5351083954684417,12,1962,1983,1971.9730769230769,3.3141859232439477,21,7
1889,1907,1897.3846153846155,2.8322047986302157,18,2375,2389,2382.0846153846155,2.5530196078191643,14,1962,1983,1970.9423076923076,3.3404821371803366,21,7
1890,1903,1897.4807692307693,2.807122660294279,13,2375,2391,2382.0846153846155,2.674156642964984,16,1963,1982,1971.0961538461538,3.411651709856589,19,7
1890,1906,1898.2692307692307,2.6835361375182187,16,2375,2391,2382.5692307692307,2.793921868270372,16,1962,1983,1972.4038461538462,3.620296791224286,21,7
1889,1906,1898.6115384615384,3.023565989349545,17,2377,2389,2382.8153846153846,2.612073586813439,12,1960,1983,1971.9653846153847,3.7481982603632638,23,7
1889,1913,1899.2692307692307,4.04947865759006,24,2375,2389,2382.6576923076923,2.6585148518865225,14,1957,1980,1969.8961538461538,3.897428195611376,23,7
1885,1913,1899.6692307692308,4.970784858420459,28,2370,2395,2382.45,3.545811602832266,25,1943,1981,1968.5615384615385,5.945055823429141,38,7
1885,1918,1901.8961538461538,5.608940792183209,33,2370,2395,2382.75,3.7759398840185483,25,1943,1981,1969.5615384615385,6.3129502812346985,38,7
1860,1918,1896.85,12.398024191822012,58,2349,2419,2382.730769230769,7.917809904999847,70,1960,2003,1977.5461538461539,9.502376486708938,43,7
1860,1912,1891.176923076923,11.849093205853764,52,2349,2419,2382.526923076923,9.42903008037456,70,1964,2006,1985.4538461538461,8.033819959537501,42,7
1869,1912,1892.8,7.67123695683274,43,2367,2413,2382.6153846153848,5.942302526038144,46,1968,2006,1981.823076923077,7.711462044686914,38,7
1880,1903,1892.7269230769232,3.9561357156965435,23,2374,2389,2381.8615384615387,2.7781659630421864,15,1965,1987,1974.1115384615384,4.644823325421939,22,7
1880,1905,1894.8961538461538,4.027989023656293,25,2374,2389,2381.6923076923076,2.566027393559271,15,1962,1980,1970.3538461538462,3.3882867470872475,18,7
1889,1905,1897.003846153846,2.9506861670717974,16,2371,2391,2381.892307692308,2.610481261111141,20,1960,1976,1968.696153846154,3.315458210001016,16,7
1889,1909,1898.0153846153846,3.2274991582881656,20,2371,2391,2381.642307692308,2.9050180359388116,20,1960,1980,1967.7269230769232,3.288925807468598,20,7
1888,1909,1896.6884615384615,3.7569833996072255,21,2373,2391,2380.9884615384617,2.864349761202279,18,1955,1980,1965.4576923076922,3.8316577132620853,25,7
1882,1913,1895.6615384615384,4.7347460351976665,31,2372,2398,2381.223076923077,3.9186030617364085,26,1954,1998,1966.8307692307692,8.747543250508276,44,7
1882,1927,1903.003846153846,8.346038330031549,45,2362,2405,2384.0346153846153,5.899639561511106,43,1954,2013,1980.9730769230769,14.808795719113377,59,7
1886,1927,1905.45,6.330763889813884,41,2356,2407,2384.8115384615385,6.478883246820252,51,1962,2013,1982.946153846154,11.693849842807294,51,7
1886,1918,1903.0,5.110364968945967,32,2356,2407,2383.7115384615386,5.574821147680957,51,1960,1993,1973.7961538461539,5.8363116274350375,33,7
1889,1918,1901.8615384615384,5.171579366618397,29,2368,2396,2383.0153846153844,3.895318674191827,28,1958,1990,1971.1653846153847,5.865904513272931,32,7
1889,1908,1899.0576923076924,3.8715548218947817,19,2374,2390,2381.9692307692308,2.8241606852096033,16,1956,1979,1967.9576923076922,4.913355298679335,23,7
1886,1907,1897.1538461538462,3.791804897114879,21,2367,2389,2381.0692307692307,3.143144679991438,22,1944,1978,1963.696153846154,6.038165665948941,34,7
1843,1943,1895.7269230769232,20.731936039916096,100,2360,2467,2381.019230769231,11.50237575697508,107,1941,2069,1973.5346153846153,24.155280201801876,128,7
1843,1943,1890.7076923076922,24.199762644053184,100,2343,2467,2381.2846153846153,16.379540216054224,124,1941,2069,1991.6307692307691,22.56680805211109,128,7
1853,1917,1882.2692307692307,12.457054233573851,64,2343,2428,2379.7653846153844,12.86230739754542,85,1942,2031,1987.4653846153847,14.040576672195245,89,7
1860,1898,1880.3961538461538,5.745636636817574,38,2355,2418,2378.896153846154,6.083776817269053,63,1951,2004,1977.4307692307693,6.22355528075716,53,7
1859,1898,1878.6461538461538,6.127804268250182,39,2362,2397,2378.476923076923,4.455208889478276,35,1962,1990,1976.4846153846154,4.124949262137222,28,7
1853,1925,1885.6615384615384,16.070815221111275,72,2336,2432,2380.023076923077,10.072682108501432,96,1904,2016,1977.8115384615385,13.411480903234365,112,7
1853,1925,1896.9307692307693,12.690669945006986,72,2336,2432,2381.5384615384614,9.900004950003714,96,1904,2016,1971.003846153846,16.325241151771653,112,7
1887,1911,1899.6076923076923,4.689586185605142,24,2372,2391,2381.380769230769,3.4109203720371113,19,1950,1978,1963.35,6.887723396793282,28,7
1893,1912,1902.8384615384616,4.085578452551278,19,2372,2391,2382.35,3.2508686097944217,19,1950,1978,1964.2038461538461,5.578570468359118,28,7
1896,1920,1907.1423076923077,4.229759714317971,24,2373,2391,2383.126923076923,2.8709781595330175,18,1955,1978,1966.9038461538462,4.793253042065975,23,7
1899,1920,1908.573076923077,3.59193193866129,21,2376,2391,2383.2884615384614,2.7825749752205224,15,1955,1979,1968.5,4.748907616718139,24,7
1899,1916,1907.1192307692309,3.462598755211198,17,2374,2391,2383.4538461538464,2.9685911494399853,17,1955,1979,1968.05,4.534871322877631,24,7
1899,1915,1907.0461538461539,3.1838432337126363,16,2374,2391,2383.507692307692,2.798913616730147,17,1960,1978,1968.2384615384615,3.4232993323661196,18,7
1900,1915,1907.0807692307692,2.954810126032277,15,2375,2391,2383.346153846154,2.6280680940078223,16,1956,1977,1967.1576923076923,3.7594332396437475,21,7
1900,1917,1907.5961538461538,3.0495243972788693,17,2375,2391,2383.4115384615384,2.6340254911618244,16,1956,1976,1966.5,3.659757149569134,20,7
1901,1917,1908.1038461538462,2.851671699552998,16,2377,2391,2383.25,2.573063615742209,14,1956,1976,1966.123076923077,4.077464926362976,20,7
1900,1916,1907.4769230769232,2.968861265559106,16,2377,2391,2383.4538461538464,2.67004414366799,14,1956,1979,1967.2153846153847,4.519344291429104,23,7
1900,1920,1908.803846153846,4.112790180041168,20,2376,2391,2383.9346153846154,2.799536959464402,15,1958,1979,1968.7961538461539,3.7838287048120547,21,7
1902,1922,1911.1538461538462,3.6124228780140135,20,2376,2391,2384.3192307692307,2.717385643258007,15,1958,1981,1969.0461538461539,3.723786710673353,23,7
1905,1922,1911.5192307692307,2.983159843059478,17,2378,2392,2384.5692307692307,2.569312398554563,14,1960,1981,1968.8384615384616,3.7319529106719083,21,7
1889,1922,1908.626923076923,5.505634719268403,33,2373,2396,2384.0384615384614,3.1766616267992864,23,1950,2017,1969.2961538461539,10.685066285271306,67,7
1873,1922,1897.7807692307692,10.494805452743822,49,2358,2402,2383.4269230769232,6.3421162376953,44,1950,2059,1990.7230769230769,29.008989522585466,109,7
1859,1913,1886.0961538461538,9.821691413174323,54,2348,2402,2381.742307692308,9.166359221203443,54,1959,2059,1999.9653846153847,22.97545176969071,100,7
1859,1925,1890.003846153846,12.439039950081153,66,2348,2411,2382.1576923076923,8.868088339264038,63,1959,2024,1991.9384615384615,12.633689010344446,65,7
1874,1942,1906.0807692307692,16.30468865059594,68,2364,2411,2385.5692307692307,6.472917695959334,47,1976,2021,1996.45,9.25034696208304,45,7
1874,1942,1920.1038461538462,13.756598438349524,68,2369,2398,2387.6346153846152,4.14518768363761,29,1976,2009,1995.8153846153846,6.22584551375573,33,7
1916,1936,1927.4423076923076,4.269915687947478,20,2382,2398,2388.596153846154,2.766732984010457,16,1983,2007,1993.1538461538462,4.670554336915246,24,7
1922,1937,1929.15,2.8577267743089636,15,2383,2395,2388.6961538461537,2.600115941761619,12,1979,2003,1992.7846153846153,3.603911678742889,24,7
1920,1937,1928.2730769230768,3.0489010226305227,17,2381,2395,2388.4153846153845,2.582341625054336,14,1979,2003,1990.5807692307692,4.281280004783438,24,7
1920,1939,1928.7807692307692,3.236199595665852,19,2381,2395,2388.5807692307694,2.56446148859029,14,1981,2001,1989.6576923076923,3.9055126940043867,20,7
1920,1939,1929.5076923076922,2.8126744410147277,19,2379,2399,2388.630769230769,2.619022958906863,20,1979,2001,1990.0,4.13666159021609,22,7
1894,1935,1921.75,10.591529725705438,41,2376,2399,2387.2653846153844,3.5752735465389125,23,1963,2001,1985.2692307692307,6.922949871784059,38,7
1886,1935,1907.2115384615386,10.724951131570567,49,2375,2396,2384.6769230769232,3.541732195390688,21,1963,2001,1980.6,6.346007774326681,38,7
1886,1910,1899.1384615384616,4.1371354239243265,24,2375,2390,2383.2038461538464,2.640782142421128,15,1968,1991,1979.2769230769231,4.168303608754403,23,7
1889,1930,1900.9307692307693,8.009346337225574,41,2376,2395,2383.8038461538463,3.4590802412254207,19,1966,2003,1980.8923076923077,6.683404392066536,37,7
1890,1950,1913.2307692307693,14.124126220440735,60,2376,2405,2386.223076923077,4.463088226683014,29,1966,2040,1993.6307692307691,15.136770775889735,74,7
1874,1950,1913.7846153846153,13.810065500131026,76,2358,2411,2386.3076923076924,6.052978658359093,53,1952,2040,1993.4192307692308,16.65541105925391,88,7
1870,1927,1896.8807692307691,12.42604436482417,57,2351,2419,2383.4,8.626617692846532,68,1952,2013,1983.1846153846154,10.485720840759665,61,7
1870,1917,1896.0192307692307,11.516800527346751,47,2351,2419,2383.5692307692307,7.563311629417553,68,1963,2013,1986.8076923076924,8.553800802421586,50,7
1877,1917,1905.3923076923077,7.37730648845844,40,2376,2397,2385.246153846154,3.194013556909645,21,1968,2004,1989.7769230769231,6.338904067873624,36,7
1896,1917,1906.1576923076923,4.222816593481178,21,2379,2392,2385.0923076923077,2.685428012724156,13,1974,1999,1986.8192307692307,5.079485520323209,25,7
1896,1913,1904.446153846154,3.6360731044669086,17,2376,2392,2384.2923076923075,2.9301947010464997,16,1970,1999,1982.0307692307692,4.813812914187128,29,7
1896,1911,1903.75,3.0420159440510837,15,2376,2392,2384.0615384615385,2.699217235750707,16,1970,1992,1981.1653846153847,4.15523508552508,22,7
1890,1950,1908.373076923077,9.637205000710539,60,2332,2401,2384.723076923077,5.761026539552373,69,1939,2024,1985.126923076923,15.103863263307355,85,7
1862,1950,1905.0846153846153,15.42726594703464,88,2332,2421,2383.492307692308,8.414224170960054,89,1939,2026,1986.9807692307693,19.36969170985839,87,7
1862,1923,1896.2269230769232,11.248957315637778,61,2355,2421,2382.3346153846155,7.440338883991959,66,1944,2026,1986.4038461538462,14.471193080234581,82,7
1878,1913,1898.2576923076922,5.961178984534426,35,2361,2408,2383.396153846154,4.8019446486472965,47,1944,2014,1986.0192307692307,7.602809845887083,70,7
1878,1912,1898.1307692307691,4.783156518303189,34,2376,2391,2383.4076923076923,3.191920673882355,15,1975,2000,1986.1538461538462,4.711706506158697,25,7
1878,1907,1895.996153846154,4.1696625206466695,29,2376,2391,2383.0576923076924,3.0593452092879465,15,1972,2000,1986.8076923076924,5.0198004141993735,28,7
1868,1907,1892.326923076923,7.1263314920511895,39,2367,2391,2381.757692307692,3.822173983352139,24,1962,1999,1982.4807692307693,7.147347118656742,37,7
1855,1975,1902.8538461538462,31.807969069824253,120,2353,2447,2382.9192307692306,12.862699934269228,94,1944,2053,1988.326923076923,23.00421411272002,109,7
1855,1975,1911.5230769230768,36.07440089263299,120,2349,2464,2385.473076923077,17.228961378652812,115,1944,2059,2006.3846153846155,25.29528611918631,115,7
1859,1967,1900.946153846154,23.5039835737954,108,2349,2464,2384.5576923076924,12.51163699485644,115,1965,2059,2005.5615384615385,15.886180024496626,94,7
1870,1915,1900.0307692307692,7.602009957278099,45,2369,2394,2384.6769230769232,3.9293281664452313,25,1982,2007,1996.376923076923,4.575012517003591,25,7
1871,1915,1898.1307692307691,8.253594945345302,44,2363,2405,2383.8653846153848,5.5068537365212515,42,1961,2020,1991.6346153846155,11.628464686758566,59,7
1860,1923,1891.5961538461538,12.730135734011473,63,2363,2405,2382.257692307692,6.3177553976102345,42,1961,2061,2002.6461538461538,23.459275989203714,100,7
1860,1931,1899.3692307692309,17.285760185699246,71,2341,2423,2383.7,8.240262768985618,82,1971,2063,2012.1807692307693,25.565911776540357,92,7
1860,1931,1896.8692307692309,17.215593390198777,71,2341,2423,2383.4115384615384,9.362903343192164,82,1971,2063,2008.376923076923,21.907409717595566,92,7
1860,1907,1883.8461538461538,9.422688087114567,47,2360,2405,2381.1346153846152,6.471884086978354,45,1979,2034,2001.0346153846153,13.120864998432776,55,7
1867,1893,1879.823076923077,5.300200891676607,26,2370,2388,2379.1384615384613,3.3594305597487337,18,1959,2004,1983.2653846153846,10.83799416922327,45,7
1867,1894,1880.5423076923078,6.164581425536056,27,2370,2386,2378.8346153846155,3.187747090302415,16,1958,1994,1977.1923076923076,7.7674662106462575,36,7
1869,1894,1882.0230769230768,4.267983319517734,25,2371,2386,2379.369230769231,2.8424212353833975,15,1958,1994,1977.803846153846,5.612656737403033,36,7
1871,1887,1879.3846153846155,3.0564435774028844,16,2370,2387,2378.3230769230768,2.6310160247032552,17,1958,1986,1973.926923076923,5.082945798091692,28,7
1871,1886,1878.5076923076922,2.8764686464607734,15,2370,2387,2377.746153846154,2.654671815362955,17,1958,1984,1972.6846153846154,4.773696616688097,26,7
1867,1886,1878.6192307692309,3.1618526447815603,19,2371,2385,2377.9538461538464,2.8294140039208835,14,1963,1994,1976.673076923077,6.021586502700432,31,7
1863,1890,1877.503846153846,4.94564905845983,27,2359,2395,2377.8076923076924,4.732368053660598,36,1958,1997,1977.4692307692308,6.101697290976489,39,7
1856,1897,1878.4884615384615,7.355549840366351,41,2353,2405,2378.0423076923075,6.798970685037728,52,1953,2014,1979.3807692307691,9.899749196572314,61,7
1855,1897,1877.823076923077,8.668467139138414,42,2353,2405,2378.6115384615387,6.441829215926455,52,1953,2014,1983.9307692307693,9.312828750104842,61,7
1855,1895,1878.3692307692309,7.91376149676126,40,2368,2390,2378.373076923077,4.290067336846563,22,1955,1998,1977.8961538461538,8.905379085461588,43,7
1867,1895,1879.4,5.487226303849014,28,2370,2386,2377.6692307692306,3.002928973116483,16,1955,1983,1971.0384615384614,5.146358079749357,28,7
1865,1936,1880.9653846153847,11.406272145317429,71,2365,2402,2378.1,5.116179196948596,37,1957,2029,1975.7346153846154,12.904563327666482,72,7
1865,1950,1893.9769230769232,18.885333887856895,85,2350,2475,2381.6846153846154,13.282516517032644,125,1941,2034,1985.4846153846154,19.230258739883123,93,7
1871,1950,1897.1076923076923,15.410344093455704,79,2350,2475,2383.1576923076923,13.053873316131444,125,1941,2034,1986.946153846154,17.07119388987369,93,7
1859,1909,1889.0192307692307,8.850300225292592,50,2363,2402,2381.3192307692307,6.1714574807647695,39,1954,2012,1985.6384615384616,12.910445231656269,58,7
1853,1949,1889.5461538461539,16.339124014676354,96,2355,2413,2382.1807692307693,9.592569487232781,58,1954,2050,1992.2961538461539,16.401360259277837,96,7
1853,1949,1892.3807692307691,18.618430674897407,96,2355,2413,2383.5307692307692,10.459843020252073,58,1973,2083,2006.8192307692307,20.804337965205196,110,7
1859,1965,1909.326923076923,24.103638163882497,106,2353,2424,2385.3230769230768,11.3029298040916,71,1946,2083,2005.3961538461538,22.368638083396355,137,7
1785,2039,1908.6038461538462,32.042695705641684,254,2333,2429,2384.5884615384616,12.524719247096609,96,1881,2358,2020.446153846154,42.56814868475351,477,7
1785,2039,1888.1192307692309,27.010744597850753,254,2333,2453,2380.742307692308,12.708452575147254,120,1881,2358,2052.1807692307693,32.76690249352079,477,7
1823,1970,1895.2038461538461,23.972329299060032,147,2355,2453,2381.9692307692308,11.671460398038791,98,1997,2090,2049.753846153846,18.692001278378722,93,7
1846,1970,1901.8,19.324459863984533,124,2359,2405,2384.357692307692,6.8044201553206305,46,1997,2068,2039.0423076923078,13.787204438790564,71,7
1847,1962,1896.8153846153846,14.235354658220576,115,2339,2430,2383.4653846153847,9.955632941437086,91,2002,2089,2043.2192307692308,15.068249347622913,87,7
1848,1962,1897.2884615384614,15.981089860996123,114,2339,2430,2382.2923076923075,10.921938641502418,91,2002,2098,2055.0538461538463,17.72824090795603,96,7
1793,1954,1898.35,17.116131838472416,161,2325,2417,2378.1115384615387,10.363241652435667,92,2020,2183,2082.257692307692,29.86143899840628,163,7
1793,1954,1895.4576923076922,16.04296049756969,161,2325,2449,2375.0730769230768,10.816406017926617,124,1979,2183,2099.230769230769,18.78800178276048,204,7
1867,1996,1917.75,29.112267710951876,129,2348,2449,2377.753846153846,10.213596463418394,101,1979,2154,2097.3884615384613,16.12712113906373,175,7
1867,2096,1947.8461538461538,22.417402760800517,229,2271,2443,2380.9,16.74812269777165,172,2014,2167,2101.873076923077,28.867211064906748,153,7
1867,2096,1930.25,29.931114607071045,229,2271,2443,2383.6653846153845,15.84162549447178,172,2014,2167,2072.9576923076925,40.31461860688345,153,7
1875,1971,1906.1346153846155,12.613085143608476,96,2366,2413,2384.757692307692,6.519864098171668,47,2008,2083,2049.3346153846155,14.543223881084993,75,7
1828,1971,1903.4730769230769,20.791000014806446,143,2339,2453,2382.7653846153844,13.026656433781381,114,2008,2104,2059.9461538461537,16.76285263292702,96,7
1828,1948,1896.5576923076924,19.155544437182744,120,2339,2453,2381.0653846153846,12.134683127322882,114,2010,2104,2061.642307692308,13.675180377624214,94,7
1867,1906,1889.8346153846153,6.714787594434572,39,2364,2393,2379.9115384615384,4.460450565315039,29,2039,2094,2062.4384615384615,8.883200792015023,55,7
1861,1929,1889.553846153846,9.391988320342216,68,2357,2394,2378.7384615384617,4.938312665975291,37,2045,2094,2069.8615384615387,10.29844524469468,49,7
1830,1929,1887.8692307692309,14.909191516778892,99,2348,2403,2379.026923076923,8.431603432440145,55,2002,2091,2065.7346153846156,15.852199640498899,89,7
1830,1941,1893.3846153846155,16.48346995340428,111,2314,2425,2381.2,13.13482211998138,111,2002,2101,2062.7961538461536,19.68204757470616,99,7
1820,2003,1901.5,22.39148003992542,183,2314,2425,2382.4884615384617,14.056005653146801,111,1945,2113,2058.5346153846153,30.026930541874535,168,7
1820,2003,1899.7576923076922,23.882897599386844,183,2344,2419,2382.396153846154,10.651770595080276,75,1945,2133,2054.4307692307693,26.76840137451828,188,7
1806,1993,1899.196153846154,19.830458628006802,187,2318,2432,2383.1,11.474901266388269,114,1975,2133,2054.55,17.063627237998798,158,7
1806,1993,1899.446153846154,19.098428866008458,187,2318,2432,2383.05,11.116503088950271,114,1975,2092,2053.5384615384614,15.727483185612611,117,7
1838,1941,1897.8192307692307,11.626508096831591,103,2363,2406,2381.0346153846153,5.759225756877508,43,2012,2093,2066.9423076923076,14.535289850039145,81,7
1861,1949,1899.3307692307692,14.552733804411497,88,2364,2407,2380.846153846154,5.525597210458298,43,2040,2093,2070.0807692307694,11.24615830522035,53,7
1861,1949,1901.6692307692308,17.228596350966384,88,2364,2407,2383.423076923077,5.986297589976531,43,2020,2082,2052.3846153846152,15.8970552215297,62,7
1857,1941,1902.8538461538462,18.728547176929645,84,2362,2404,2384.507692307692,6.769504813957622,42,2010,2093,2047.4153846153847,16.899103088024678,83,7
1833,1943,1899.2,22.890506538198093,110,2349,2404,2382.769230769231,8.187982965484542,55,2010,2095,2055.742307692308,16.93021500106186,85,7
1833,1943,1892.9115384615384,22.51014060499023,110,2349,2399,2379.2961538461536,7.386253577202851,50,2025,2108,2067.6961538461537,17.134601826263125,83,7
1852,1940,1892.1,15.501575458605547,88,2357,2401,2377.5923076923077,6.19901119758142,44,2046,2108,2081.007692307692,12.037262707762654,62,7
1864,1921,1888.6653846153847,6.647752969434072,57,2357,2401,2377.0730769230768,4.836161860242226,44,2049,2102,2083.9115384615384,7.785980219053216,53,7
1877,1900,1886.7653846153846,4.444722027928621,23,2370,2386,2376.65,2.751728133738455,16,2072,2100,2082.8076923076924,4.140572683137218,28,7
1878,1903,1890.253846153846,4.464033078684714,25,2363,2388,2375.8884615384613,3.5877125054386703,25,2072,2109,2088.096153846154,7.582390733973635,37,7
1876,1903,1890.3,4.383454324465103,27,2363,2388,2374.880769230769,3.6630808847419094,25,2082,2109,2093.4423076923076,4.687177372324597,27,7
1853,1914,1890.8115384615385,7.889625998499447,61,2362,2396,2375.9192307692306,5.3297822241230985,34,2031,2109,2086.857692307692,18.016051896243134,78,7
1853,1916,1893.5576923076924,9.015673742564836,63,2362,2396,2378.4538461538464,5.930890976528551,34,2031,2109,2073.619230769231,19.029879355537393,78,7
1855,1925,1892.7038461538461,10.526340587015326,70,2350,2404,2379.003846153846,5.943425735576199,54,2046,2123,2074.2346153846156,12.896183096619653,77,7
1855,1925,1892.6807692307693,10.417260670124362,70,2350,2412,2378.4615384615386,7.740136427073615,62,2046,2123,2081.8192307692307,10.45315046377668,77,7
1875,1930,1893.9730769230769,8.845479952637708,55,2355,2412,2379.5807692307694,8.115313672823499,57,2019,2101,2074.25,14.905720443188981,82,7
1836,1941,1899.7846153846153,18.412051037394594,105,2361,2411,2381.992307692308,8.483457583382648,50,2009,2089,2055.1576923076923,18.95885960674738,80,7
1788,1992,1904.3153846153846,27.720623496468598,204,2348,2415,2383.853846153846,9.797652810443969,67,1966,2158,2043.7692307692307,19.728089243449432,192,7
1788,2039,1906.0692307692307,41.05043295433126,251,2348,2415,2381.1153846153848,12.553597595622245,67,1966,2158,2067.1576923076923,33.07313380951645,192,7
1814,2039,1901.6846153846154,41.53280038202948,225,2298,2441,2375.3884615384613,18.739606167762417,143,1957,2209,2098.9846153846156,34.47868450477317,252,7
1826,1981,1900.75,27.08265269910016,155,2298,2441,2374.730769230769,17.318630342349735,143,1957,2209,2100.2961538461536,31.29053023595609,252,7
1851,1974,1913.3461538461538,19.84173345991692,123,2303,2425,2378.3384615384616,14.023727188765625,122,1986,2163,2093.9,21.999245336301776,177,7
1824,2062,1928.5692307692307,30.785203902666932,238,2280,2482,2376.4538461538464,28.418171232372714,202,1986,2247,2111.873076923077,35.84699421648897,261,7
1824,2062,1930.5230769230768,32.3498528422152,238,2280,2482,2374.9076923076923,28.96821481481849,202,1982,2248,2117.9,33.5962513996444,266,7
1832,2038,1920.1115384615384,31.45443265314658,206,2311,2505,2379.8076923076924,23.51951334886647,194,1982,2248,2091.596153846154,31.338640842582976,266,7
1832,2038,1913.8461538461538,29.167857047851232,206,2311,2505,2381.5153846153844,21.103984002508646,194,2002,2150,2080.4269230769232,19.936928691027752,148,7
1846,1977,1909.0,14.454562011156302,131,2335,2422,2380.2653846153844,9.83428100387023,87,2049,2115,2084.1346153846152,10.527824589395976,66,7
1850,1931,1909.7,7.706137552922085,81,2370,2399,2381.4269230769232,3.938529378081832,29,2064,2104,2080.7884615384614,8.753458309321658,40,7
1898,1954,1921.4346153846154,12.979920409167919,56,2368,2394,2379.8884615384613,4.551619587272301,26,2068,2123,2093.723076923077,17.45242419227513,55,7
1910,1954,1929.7230769230769,10.265220649102238,44,2360,2390,2374.8038461538463,4.748906053198853,30,2072,2140,2117.4461538461537,10.856068913480252,68,7
1904,1952,1921.6346153846155,10.623840106853011,48,2360,2381,2372.642307692308,3.546565370626337,21,2103,2140,2122.5846153846155,6.647535166490193,37,7
1904,1936,1915.2153846153847,5.611604929974123,32,2367,2380,2373.403846153846,2.8192636801561677,13,2103,2135,2118.4269230769232,5.1486068657601605,32,7
1904,1927,1916.2923076923078,4.243452651661193,23,2367,2382,2374.3846153846152,2.81990885524443,15,2107,2128,2115.507692307692,3.6996215059380444,21,7
1907,1927,1916.3846153846155,4.101764598861425,20,2366,2383,2374.423076923077,2.887505729464331,17,2105,2123,2114.973076923077,3.387925150890561,18,7
1907,1926,1915.4076923076923,3.73276456979694,19,2365,2383,2374.1692307692306,2.7999957571353997,18,2105,2123,2114.7038461538464,3.4496914717654463,18,7
1907,1924,1915.496153846154,3.523224739228618,17,2365,2383,2374.523076923077,2.8139623875212547,18,2104,2122,2113.7153846153847,3.5515717666495226,18,7
1907,1936,1919.6,5.581408742613602,29,2365,2383,2374.7961538461536,2.816249151133344,18,2100,2126,2114.642307692308,4.653115623051399,26,7
1911,1936,1925.6538461538462,4.621105750209397,25,2369,2385,2376.7384615384617,3.2288607937695337,16,2096,2126,2109.7,7.056473793179027,30,7
1916,1936,1927.3576923076923,3.365584745205605,20,2372,2385,2378.173076923077,2.647364492951199,13,2096,2114,2105.276923076923,3.216788452436366,18,7
1916,1969,1932.6576923076923,9.875388583407728,53,2344,2387,2376.346153846154,5.58156305651438,43,2100,2165,2112.9461538461537,12.715971496347855,65,7
1879,1969,1932.0269230769231,16.57518398349545,90,2344,2403,2374.5692307692307,8.545529628178503,59,2095,2165,2119.45,14.961772395162052,70,7
1879,1952,1928.0846153846153,13.720336688567041,73,2353,2403,2376.496153846154,7.547787564518304,50,2095,2162,2112.5461538461536,12.743451063018405,67,7
1920,1939,1929.0653846153846,3.6316330402118737,19,2371,2389,2378.9653846153847,2.932107219603804,18,2092,2115,2103.1384615384613,4.113737877264341,23,7
1920,1936,1927.5692307692307,3.0401139521887734,16,2372,2389,2380.019230769231,2.9269773345887593,17,2083,2110,2097.6346153846152,5.3870603087786915,27,7
1920,1942,1929.0423076923078,3.84272597468814,22,2375,2394,2381.869230769231,3.053925789285445,19,2076,2107,2090.403846153846,6.0737412391649235,31,7
1921,1942,1931.7423076923078,4.012400958199647,21,2375,2394,2383.3153846153846,2.865140277373659,19,2072,2095,2084.257692307692,4.205041382956062,23,7
1913,1941,1928.5961538461538,6.080094795112385,28,2367,2396,2383.1884615384615,3.7825883278483348,29,2069,2095,2082.596153846154,4.45942503429216,26,7
1882,1947,1915.7115384615386,14.215843761107317,65,2357,2415,2381.492307692308,6.155947814568728,58,2068,2100,2081.4692307692308,6.230065923705897,32,7
1882,1947,1904.376923076923,11.850266200757222,65,2357,2415,2380.7115384615386,5.473476017024255,58,2060,2100,2076.8230769230768,6.9342921401111655,40,7
1887,1931,1905.8307692307692,7.548697462664229,44,2340,2418,2381.5576923076924,8.308281818616097,78,2023,2105,2072.019230769231,11.961796304676437,82,7
1887,1991,1923.8653846153845,23.262501389445866,104,2340,2418,2375.9461538461537,13.790944115256925,78,2023,2198,2097.8653846153848,44.784351947842,175,7
1877,1998,1933.0423076923078,22.36193458102671,121,2328,2452,2374.4538461538464,17.732509045306507,124,2007,2198,2110.8346153846155,44.527805224100575,191,7
1877,1998,1928.4807692307693,13.94928816580403,121,2328,2452,2381.4461538461537,15.148715321226941,124,2007,2152,2088.5884615384616,27.73182144043049,145,7
1902,1945,1919.446153846154,11.410935308266566,43,2365,2401,2382.976923076923,4.8649171696359925,36,2040,2105,2076.9,9.239289949150788,65,7
1900,1929,1913.8461538461538,7.004644392475829,29,2370,2389,2382.5576923076924,3.0352718103779375,19,2063,2087,2073.3653846153848,4.561162412609592,24,7
1900,1932,1919.5153846153846,6.500055972891898,32,2374,2394,2383.45,2.9970062282294867,20,2065,2085,2073.726923076923,3.913944745261929,20,7
1913,1935,1923.8807692307691,4.442382681035469,22,2369,2395,2384.3076923076924,3.514660204463065,26,2058,2085,2071.107692307692,4.604423177848969,27,7
1915,1935,1924.7769230769231,3.9274607604593617,20,2369,2395,2384.9307692307693,3.300142647059592,26,2058,2078,2068.2884615384614,3.5648246040968767,20,7
1913,1931,1922.1307692307691,3.6936519926848876,18,2378,2393,2385.096153846154,2.704633628616465,15,2058,2078,2066.8192307692307,3.3979915974508965,20,7
1913,1938,1922.1038461538462,3.975890737646994,25,2375,2394,2385.1846153846154,3.0384527036297326,19,2056,2082,2065.9884615384617,4.070311280164445,26,7
1908,1938,1920.873076923077,4.71701575153588,30,2375,2394,2385.4269230769232,3.064059649951603,19,2047,2082,2062.123076923077,6.167564157659622,35,7
1908,1928,1918.8,3.4627638658640287,20,2379,2392,2385.873076923077,2.745871972582278,13,2047,2067,2056.8384615384616,3.4903149975752594,20,7
1911,1928,1919.4076923076923,3.224414954197396,17,2379,2393,2386.1346153846152,2.6771508954739396,14,2044,2065,2055.6,3.171056362728114,21,7
1912,1932,1921.0615384615385,3.9156232878183945,20,2379,2393,2386.130769230769,2.5901162345929785,14,2044,2065,2055.107692307692,3.6839339260319495,21,7
1914,1933,1923.0269230769231,3.438826424163799,19,2379,2396,2386.6923076923076,2.803324429784726,17,2042,2064,2052.4,4.316798470481224,22,7
1916,1933,1923.3615384615384,3.1365422423262914,17,2378,2396,2387.1346153846152,3.041723031782973,18,2042,2060,2050.0615384615385,3.1555646654106706,18,7
1915,1931,1923.5615384615385,3.0630538327458074,16,2378,2393,2387.0153846153844,3.0070306686552835,15,2041,2060,2050.153846153846,3.4662443674458405,19,7
1909,1989,1930.4769230769232,16.621944551978288,80,2372,2400,2385.9269230769232,4.529445293396827,28,2037,2124,2059.526923076923,20.108087419871133,87,7
1906,1989,1928.753846153846,17.539392635729836,83,2372,2400,2385.019230769231,4.404676282222469,28,2037,2124,2063.2384615384617,18.66936616881337,87,7
1893,1966,1922.0076923076922,8.976585719475484,73,2360,2409,2385.753846153846,4.9547162329656125,49,2037,2085,2057.726923076923,7.9184091111285,48,7
1854,1966,1920.8384615384616,15.136344991738913,112,2360,2409,2385.2961538461536,7.837686443034627,49,2019,2096,2062.7,14.297797978256199,77,7
1854,1961,1911.003846153846,15.273945837386668,107,2361,2409,2382.0346153846153,7.504615944154668,48,2019,2098,2074.8884615384613,14.32466423152757,79,7
1850,1932,1894.2307692307693,16.526351234325293,82,2363,2392,2377.496153846154,5.0146488707289665,29,2056,2112,2082.619230769231,11.228635457269696,56,7
1836,1915,1875.6153846153845,20.343720010532582,79,2350,2390,2375.2884615384614,5.8439703885278105,40,2038,2112,2067.2846153846153,19.14171277094001,74,7
1836,1920,1879.326923076923,20.600747028706948,84,2350,2395,2377.4115384615384,7.025316982533862,45,2029,2093,2058.5923076923077,14.730629531403142,64,7
1866,2006,1907.873076923077,28.616004616747603,140,2345,2413,2378.096153846154,9.770848643771084,68,2029,2144,2084.9076923076923,27.101965665179026,115,7
1868,2006,1926.4692307692308,26.998838373849967,138,2294,2460,2378.257692307692,19.516722323496083,166,2045,2144,2101.0884615384616,18.5483782954828,99,7
1844,2003,1918.8076923076924,27.933344863652746,159,2294,2474,2378.7961538461536,22.111004279464787,180,2031,2152,2092.4576923076925,18.86474256459685,121,7
1844,2003,1921.923076923077,35.35186950862256,159,2335,2474,2379.4576923076925,17.425022461431944,139,2031,2152,2086.5346153846153,21.6347968378359,121,7
1849,1990,1930.2923076923078,27.601814655202872,141,2324,2437,2381.1153846153848,14.220347928876254,113,2038,2146,2089.596153846154,19.102102832943096,108,7
1889,1992,1928.5653846153846,19.523660377176064,103,2324,2437,2383.826923076923,10.986339629269544,113,2022,2138,2074.4846153846156,26.725758579807827,116,7
1883,1992,1920.5807692307692,23.930828878970548,109,2367,2407,2383.7923076923075,7.173736046335192,40,2022,2106,2066.519230769231,21.179222703146458,84,7
1838,1984,1898.0384615384614,26.71063410812208,146,2350,2440,2377.6769230769232,9.453168768323126,90,2041,2158,2082.6884615384615,19.646663129940723,117,7
1838,1958,1898.1576923076923,24.225017750282145,120,2336,2440,2376.4576923076925,9.731637418994136,104,2048,2158,2088.730769230769,19.036152746159384,110,7
1851,1935,1902.6576923076923,17.00675934385688,84,2336,2394,2378.273076923077,6.731936086220923,58,2043,2118,2086.357692307692,16.777183280392414,75,7
1841,1935,1891.8346153846153,17.60505022110966,94,2355,2394,2377.753846153846,5.455416405882154,39,2043,2118,2081.153846153846,16.123539250689284,75,7
1841,1935,1894.8576923076923,16.61251965614516,94,2364,2400,2379.4384615384615,5.8777820602946775,36,2042,2105,2073.346153846154,11.975336003998905,63,7
1871,1936,1912.053846153846,15.97044158609913,65,2361,2423,2382.0653846153846,7.964178600341706,62,2042,2105,2074.3192307692307,11.552549710406131,63,7
1903,1940,1925.2307692307693,6.666968610130877,37,2361,2423,2382.9269230769232,6.892895883590123,62,2068,2095,2081.55,5.79386908023636,27,7
1912,1940,1927.9303797468353,4.561144521424385,28,2376,2392,2383.1835443037976,2.80545103517483,16,2069,2093,2081.1645569620255,5.3701946488743175,24,7
